"a" = (/obj/MapMarker/MapInfo/MapName{name = "Splatterhouse"},/turf/Floor/Sand,/area)
"b" = (/turf/Wall/Inner_Wall,/area)
"c" = (/turf/Wall/Outer_Wall,/area)
"d" = (/turf/Floor/Sand,/area)
"e" = (/obj/MapMarker/MapInfo/SupportsGameMode/DM,/turf/Floor/Sand,/area)
"f" = (/turf/Floor/DirtRoad,/area)
"g" = (/turf/Floor/Generic/Basic,/area)
"h" = (/obj/MapMarker/Start/Defend,/turf/Floor/Generic/Basic,/area)
"i" = (/obj/Furniture/Bed,/turf/Floor/Generic/Basic,/area)
"j" = (/obj/MapMarker/MapInfo/SupportsGameMode/EXTENDED,/turf/Floor/Sand,/area)
"k" = (/obj/MapMarker/MapInfo/SupportsGameMode/MAYHEM,/turf/Floor/Sand,/area)
"l" = (/mob/Soldier,/turf/Floor/Sand,/area)
"m" = (/obj/Furniture/Table,/turf/Floor/Generic/Basic,/area)
"n" = (/mob/Soldier,/turf/Floor/Generic/Basic,/area)
"o" = (/obj/MapMarker/MapInfo/SupportsGameMode/TDM,/turf/Floor/Sand,/area)
"p" = (/obj/MapMarker/MapInfo/Info{InfoKey = "Designed by"; InfoValue = "Sukasa"},/turf/Floor/Sand,/area)
"q" = (/obj/MapMarker/Start/Spectate,/turf/Floor/Generic/Basic,/area)
"r" = (/obj/Furniture/Rack,/turf/Floor/Generic/Basic,/area)
"s" = (/obj/Furniture/Table/Strong_Table,/turf/Floor/Generic/Basic,/area)
"t" = (/obj/MapMarker/Start/Attack,/turf/Floor/Generic/Basic,/area)
"u" = (/obj/Furniture/Table/Strong_Table,/obj/Item/tank,/turf/Floor/Generic/Basic,/area)
"v" = (/mob/Soldier/bot{move = 1},/turf/Floor/Generic/Basic{tag = "A"},/area)
"w" = (/obj/Item/medkit,/turf/Floor/Generic/Basic,/area)
"x" = (/obj/Item/tank,/turf/Floor/Generic/Basic{tag = "B"},/area)
"y" = (/obj/Item/tank,/turf/Floor/Generic/Basic,/area)
"z" = (/mob/Soldier/bot{shoot = 1},/turf/Floor/Generic/Basic,/area)

(1,1,1) = {"
abbccccccccccccccccccccccccccccccccccccccccccccccccccccccccbbbbbbbbbbbbbbbbbbbbbbbbbbbbbbd
ebdfggggghgbggggggggggggggggggggggggggbiggbiggbiggbiggbiggfdddddddddddddddddddddddddddddbd
jbdfgggggggbgggggghgggggggggggggggggggbgggbgggbgggbgggbgggcdddddddddddddddddddddddddddddbd
kblcggmmmggggggggggggggggggggggghgggggbgggbgggbgggbnggbgggcdddddddddddddddddddddddddddddbd
obdcggggmgggggggggggggggggghggggggggggbnggbgggbgggbgggbgggcdddddddddddddddddddddddddddddbd
pbdcggggmggbgggggggghgggggggggggggggggbbbgbbbgbbbgbbbgbbbgcdddddddddddddddddddddddddddddbd
dbdcbbbbbbbbgggggggggggggggggggggggghgggggggggggggggggggggcdddddddddddddddddddddddddddddbd
dbdcgggggggbgghgggggggggggggggggggggggggggggqgggggggggggggcdddddddddddddddddddddddddddddbd
dbdcggggghgbgggggggggggggghggbbbbbbbbbbbbbbbbbbbbbbbbbbbbbcdddddddddddddddddddddddddddddbd
dbdcggmmmgggggggghgggggggggggbggggggggggggggggggggggggggggcdddddddddddddddddddddddddddddbd
dbdcgggnmggggggggggggggggggggbggggggggggggggggggggggggggggcdddddddddddddddddddddddddddddbd
dbdcggggmggbggggggggggggrrrrrbggggggggggggggggggggggggggggcdddddddddddddddddddddddddddddbd
dbdcbbbbbbbbbbbbggggbbbbbbbbbbggggggggggggggggggggggggggggcdddddddddddddddddddddddddddddbd
dbdcrrrrgqggggsgggggggggggggggggggcccccccccccccccccccggggccdddddddddddddddddddddddddddddbd
dbdcrrggggggggsgggggggggggggggggggcddddddddddddddddddffffdddddddddddddddddddddddddddddddbd
dbdcrgggggggggsgggggggggggggggggggcddddddddddddddddddfffffffffddddddddddddddddddddddddddbd
dbdcrgggggggggsgggggggggggggggggggcddddddddddddddddddfffffffffddddddddddddddddddddddddddbd
dbdcggggggggggsgggggbbggggggggggggcddddddddddddddddddfffffffffddddddddddddddddddddddddddbd
dbdcgggggggggssggggbbbggggggggggggcddddddddddddddddddfffffffffddddddddddddddddddddddddddbd
dbdcgggggggggggggggggbggggggggggggcdddddddddddddddddddddddffffddddddddddddddddddddddddddbd
dbdcgggggggggggggggggbggggggggggggcdddddddddddddddddddddddffffddddddddddddddddddddddddddbd
dbdcgggggggggggggggggbggggggggggggcdddddddddcccccccccccccdffffddddddddddddddddddddddddddbd
dbdcgggggggggggggggggbggggggggggggcdddddddddcigiigiigiigcdffffdccccccccccccccdddddddddddbd
dbdcccccccccccccccccccccccggggcccccdddddddddcigiigiigiigcdffffdcggggggggggggcdddddddddddbd
dbddddddddddddddddddddddddffffddddddddddddddcigiigiigiigcdffffdcggggggggggggcdddddddddddbd
dbddddddddddddddddddddddddffffddddddddddddddcigiigiigiigcdffffdcggggggggggggcdddddddddddbd
dbddddddddddddddddddddddddffffddddddddddddddcgggggggggggccggggccbsssbgggggggcdddddddddddbd
dbddddddddddddddddddddddddffffddddddddddddddcgggggggggggbgggggggggggbgggggggcdddddddddddbd
dbddddddddddddddddddddddddffffddddddddddddddcbbbbbbbbggbbgggggggggggbgggggggcdddddddddddbd
dbddddddddddddddddddddddddffffffffffffffffffggggggggggggggggggggggggbgggggggcdddddddddddbd
dbddddddddddddddddddddddddffffffffffffffffffggggggggggggggggggggggggbgggggggcdddddddddddbd
dbddddddddddddddddddddddddffffffffffffffffffggggggggggggggggggggggggggggggggcdddddddddddbd
dbddddddddddddddddddddddddffffffffffffffffffggggggggggggggqgggggggggggggggggcdddddddddddbd
dbddddddddddddddddddddddddddddddffffddddddddcbbggbbbbbbbbbbbbbbbggggbgggggggcdddddddddddbd
dbddddddddddddddddddddddddddddddffffddddddddcggggggggggggggggggbggggbbcccccccdddddddddddbd
dbddddddddddddddddddddddddddddddffffddddddddcggggggggggggggggggbggggggcdddddddddddddddddbd
dbddddddddddddddddddddddddddddddffffddddddddcgggggggggggggggggggggggggcdddddddddddddddddbd
dbddddddddddddddddddddddddddddddffffddddddddcgggggggggggggggggggggggggcdddddddddddddddddbd
dbddddddddddddddddddddddddddddddffffddddddddcggggggggggggggggggbggggggcdddddddddddddddddbd
dbddddddddddddddddddddddddddddddffffddddddddcggggggggggggggggggbggggggcdddddddddddddddddbd
dbddddddddddddddddddddddddddddddffffddddddddcggggggggggggcccccccggggcccdddddddddddddddddbd
dbddddddddldddddddddddddddddddddffffddddddddcggggggggggggcddddddffffddddddddddddddddddddbd
dbddddddddddddddddddddddddddddddffffddddddddccccccccccccccddddddffffddddddddddddddddddddbd
dbddddddddddddddddddddddddddddddffffddddddddddddddddddddddddddddffffddddddddddddddddddddbd
dbddddddddddddddddddddddddddddddffffddddddddddddddddddddddddddddffffddddddddddddddddcccccd
dbddddddddddddddddddddddddddddddffffddddddddddddddddddddddddddddffffddddddddddddddddcgggcd
dbddddddddddddddddddddddddddddddffffffffffffffddddddddddddddddddffffddddddddddddddffggggcd
dbddddddddddddddddddddddddddddddffffffffffffffddddddddddddddddddffffddddddddddddddfdcgggcd
dbddddddddddddddddddddddddddddddffffffffffffffddddddddddddddddddffffddddddddddddddfdcccccd
dbddddddddddddddddddddddddddddddffffffffffffffddddddddddddddddddffffddddddddddddddfdddbddd
dbddddddddddddddddddddddddddddddffffffffffffffffffffffffffffffffffffffffffffffffffffffbfff
dbdddddddddddddddddddddddddddddddddddddddfffffffffffffffffffffffffffffffffffffffffffffbfff
dbdddddddddddddddddddddddddddddddddddddddfffffffffffffffffffffffffffffffffffffffffffffbfff
dbdddddddddddddddddddddddddddddddddddddddfffffffffffffffffffffffffffffffffffffffffffffbfff
dbdddddddddddddddddddddddddddddddddddddddfffffddddddddddddddddddddddddddddddddddddddddbddd
dbdccccccccccccccccccccccccccccccccccddddfffffddddddddddddddddddddddddddddddddddddddbbbbbd
dbdcggggggggggggggggggggggggggggggggcddddfffffddddddddddddddddddddddddddddddddddddddddddbd
dbdcgggtggggggggggggggggggggggggggggcddddfffffddddddddddddddddddddddddddddddddddddddddddbd
dbdcgggggggggggggtggggggbbbggbbbbggbcddddfffffddddddddddddddddddddddddddddddddddddddddddbd
dbdcggggggggtggggggggggnbgggggbggtggcddddfffffddddddddddddddddddddddddddddddddddddddddddbd
dbdcggggsssgggsssggggsssbggtggbgggggcddddfffffddddcccccccccccdddddddddddddddddddddddddddbd
dbdcggggsrrgggsrrgggtrrsbmmmggbmmmggcddddfffffddddcgggggggggcdddddddddddddddddddddddddddbd
dbdcggggsrrgtgsrrggggrrsbgnmggbtgmggcddddfffffddddcgggggggggcdddddddddddddddddddddddddddbd
dbdcrgggsrrgggsrrggggrrsbgggggbgggggcddddfffffffffgggbgggbggcdddddddddddddddddddddddddddbd
dbdcrggggggggggggggggbbbbbbbbbbbbbbbcddddfffffffffgggggtggggcdddddddddddddddddddddddddddbd
dbdcrgtggggggggggtgggggggggggggggggggfffffffffffffgggbgggbggcdddddddddddddddddddddddddddbd
dbdcrgggssuggtsusggggggggggggggggggggfffffffffffffggggggggggcdddddddddddddddddddddddddddbd
dbdcggggsrrnggsrrggggggvwggggggggxgggfffffffffddddcgggggggggcdddddddddddddddddddddddddddbd
dbdcggggsrrgggsrrggggggggggggggggggggfffffffffddddccccggggcccdddddddddddddddddddddddddddbd
dbdcgtggurrgggsrrggggbggggbbbbbggbcccddddfffffddddddddffffddddddddddddddddddddddddddddddbd
dbdcgggggggggggggggggbggggbgggggggcddddddfffffddddddddffffddddddddddddddddddddddddddddddbd
dbdcgggngggtggggyggggbggggbgggggggcddddddfffffddddddddffffddddddddddddddddddddddddddddddbd
dbdcbggbbbbbbbbbbbbbbbggggbgggggggcddddddfffffffffffffffffddddddddddddddddddddddddddddddbd
dbdcggggggggggggggggggggggbgggggggcddddddfffffffffffffffffddddddddddddddddddddddddddddddbd
dbdcggggggggggggqgggggggggbgggggggcddddddfffffffffffffffffddddddddddddddddddddddddddddddbd
dbdcgnggggggggggggggggggggbgggggggcddddddfffffffffffffffffddddddddddddddddddddddddddddddbd
dbdcggggggggggggggggggggggbgggggggcddddddfffffffffffffffffddddddddddddddddddddddddddddddbd
dbdcbbbbbbggbbbbbbbggbgggbbbbbggbbcdddddddddddddddddddddddddddddddddddddddddddddddddddddbd
dbdcggggggggbggggggggbggggggggggggcdddddddddddddddddddddddddddddddddddddddddddddddddddddbd
dbdfggggggggbggggggggbggggggggggggcdddddddddddddddddddddddddddddddddddddddddddddddddddddbd
dbdcbggbbbbbbbggbbbbbbsgggssgggssgcdddddddddddddddddddddddddddddddddddddddddddddddddddddbd
dbdcmgggggggbmgggggggbsgggssnggssgcdddddddddddddddddddddddddddddddddddddddddddddddddddddbd
dbdcmggbzgggbmgggbgggbsgggssgggssgcdddddddddddddddddddddddddddddddddddddddddddddddddddddbd
dbdcmggbbbbbbmgggbbbbbsnggssgggssgcdddddddddddddddddddddddddddddddddddddddddddddddddddddbd
dbdcmggbggggbmgggbgggbsgggssgggssgcdddddddddddddddddddddddddddddddddddddddddddddddddddddbd
dbdcmgggggggbmgggggggbggggggggggggcdddddddddddddddddddddddddddddddddddddddddddddddddddddbd
dbdcccccccccccccccccccggggggggggggfdddddddddddddddddddddddddddddddddddddddddddddddddddddbd
dbdddddddddddddddddddccccccccccccccdddddddddddddddddddddddddddddddddddddddddddddddddddddbd
dbbbbbbbbbbbbbbbbbbbbbbbbbbbbbbbbbbbbbbbbbbbbbbbbbbbbbbbbbbbbbbbbbbbbbbbbbbbbbbbbbbbbbbbbd
dddddddddddddddddddddddddddddddddddddddddddddddddddddddddddddddddddddddddddddddddddddddddd
"}
