"a" = (/obj/MapMarker/MapInfo/MapName{name = "Splatterhouse"},/turf/Floor/Sand,/area)
"b" = (/turf/Wall/Inner_Wall,/area)
"c" = (/turf/Wall/Outer_Wall,/area)
"d" = (/turf/Floor/Sand,/area)
"e" = (/obj/MapMarker/MapInfo/SupportsGameMode/DM,/turf/Floor/Sand,/area)
"f" = (/turf/Floor/DirtRoad,/area)
"g" = (/turf/Floor/Generic/Basic,/area)
"h" = (/obj/Furniture/Bed,/turf/Floor/Generic/Basic,/area)
"i" = (/obj/MapMarker/MapInfo/SupportsGameMode/EXTENDED,/turf/Floor/Sand,/area)
"j" = (/obj/MapMarker/MapInfo/SupportsGameMode/MAYHEM,/turf/Floor/Sand,/area)
"k" = (/mob/Soldier,/turf/Floor/Sand,/area)
"l" = (/obj/Furniture/Table,/turf/Floor/Generic/Basic,/area)
"m" = (/mob/Soldier,/turf/Floor/Generic/Basic,/area)
"n" = (/obj/MapMarker/MapInfo/SupportsGameMode/TDM,/turf/Floor/Sand,/area)
"o" = (/obj/MapMarker/MapInfo/Info{InfoKey = "Designed by"; InfoValue = "Sukasa"},/turf/Floor/Sand,/area)
"p" = (/obj/MapMarker/Zone/Spawn/Defenders,/turf/Floor/Generic/Basic,/area)
"q" = (/obj/Furniture/Rack,/turf/Floor/Generic/Basic,/area)
"r" = (/obj/Furniture/Table/Strong_Table,/turf/Floor/Generic/Basic,/area)
"s" = (/turf/Floor/Generic/Lab,/area)
"t" = (/obj/Furniture/Table/Strong_Table,/turf/Floor/Generic/Lab,/area)
"u" = (/obj/Container/WoodCrate{step_x = 28; step_y = 19},/turf/Floor/Generic/Basic,/area)
"v" = (/obj/MapMarker/Zone/Spawn/Spectator,/turf/Floor/Generic/Basic,/area)
"w" = (/obj/Container/WoodCrate{step_x = 27},/turf/Floor/Sand,/area)
"x" = (/obj/Container/WoodCrate{step_x = 28; step_y = 19},/turf/Floor/Sand,/area)
"y" = (/obj/Container/WoodCrate{step_x = 0; step_y = 0},/turf/Floor/Sand,/area)
"z" = (/obj/Container/WoodCrate{step_x = 21; step_y = 19},/turf/Floor/Sand,/area)
"A" = (/obj/Machinery/Trap/PressurePlate,/turf/Floor/Generic/Basic,/area)
"B" = (/obj/Furniture/Table/Strong_Table,/obj/Item/tank,/turf/Floor/Generic/Basic,/area)
"C" = (/mob/Soldier/bot{move = 1},/turf/Floor/Generic/Basic{tag = "A"},/area)
"D" = (/obj/Item/medkit,/turf/Floor/Generic/Basic,/area)
"E" = (/obj/Item/tank,/turf/Floor/Generic/Basic{tag = "B"},/area)
"F" = (/obj/Furniture/Table/Strong_Table{step_x = 0; step_y = 0},/turf/Floor/Generic/Basic,/area)
"G" = (/obj/Container/WoodCrate,/turf/Floor/Generic/Lab,/area)
"H" = (/obj/MapMarker/Zone/Spawn/Attackers,/turf/Floor/Generic/Basic,/area)
"I" = (/obj/Container/WoodCrate{step_x = 22; step_y = 20},/turf/Floor/Generic/Lab,/area)
"J" = (/obj/Container/WoodCrate{step_x = 31; step_y = 10},/turf/Floor/Generic/Lab,/area)
"K" = (/obj/Machinery/Trap/PressurePlate/Stealthed,/turf/Floor/Generic/Basic,/area)
"L" = (/obj/Container/WoodCrate{step_x = 4},/obj/Item/medkit,/turf/Floor/Generic/Lab,/area)
"M" = (/obj/Container/WoodCrate{step_x = 20; step_y = 16},/turf/Floor/Generic/Basic,/area)
"N" = (/obj/Container/WoodCrate{step_x = 22; step_y = 0},/turf/Floor/Generic/Lab,/area)
"O" = (/obj/Container/WoodCrate{step_x = 12; step_y = 7},/turf/Floor/Generic/Lab,/area)
"P" = (/mob/Soldier/bot{shoot = 1},/turf/Floor/Generic/Basic,/area)

(1,1,1) = {"
abbccccccccccccccccccccccccccccccccccccccccccccccccccccccccbbbbbbbbbbbbbbbbbbbbbbbbbbbbbbd
ebdfgggggggbggggggggggggggggggggggggggbhggbhggbhggbhggbhggfdddddddddddddddddddddddddddddbd
ibdfgggggggbggggggggggggggggggggggggggbgggbgggbgggbgggbgggcdddddddddddddddddddddddddddddbd
jbkcgglllgggggggggggggggggggggggggggggbgggbgggbgggbmggbgggcdddddddddddddddddddddddddddddbd
nbdcgggglgggggggggggggggggggggggggggggbmggbgggbgggbgggbgggcdddddddddddddddddddddddddddddbd
obdcgggglggbggggggggggggggggggggggggggbbbgbbbgbbbgbbbgbbbgcdddddddddddddddddddddddddddddbd
dbdcbbbbbbbbggggggggggggggggggggggggggggggggggggggggggggggcdddddddddddddddddddddddddddddbd
dbdcgggggggbggggggggggggggggggggggggggggggggggggggggggggggcdddddddddddddddddddddddddddddbd
dbdcgggggggbgggggggggggggggggbbbbbbbbbbbbbbbbbbbbbbbbbbbbbcdddddddddddddddddddddddddddddbd
dbdcgglllgggggpggggggggggggggbggggggggggggggggggggggggggggcdddddddddddddddddddddddddddddbd
dbdcgggmlggggggggggggggggggggbggggggggggggggggggggggggggggcdddddddddddddddddddddddddddddbd
dbdcgggglggbggggggggggggqqqqqbggggggggggggggggggggggggggggcdddddddddddddddddddddddddddddbd
dbdcbbbbbbbbbbbbggggbbbbbbbbbbggggggggggggggggggggggggggggcdddddddddddddddddddddddddddddbd
dbdcqqqqggggggrgggggggggggggggggggcccccccccccccccccccggggccdddddddddddddddddddddddddddddbd
dbdcqqggggggggrgggggggggggggggggggcddddddddddddddddddffffdddddddddddddddddddddddddddddddbd
dbdcqgggggggggrgggggggggggggggggggcddddddddddddddddddfffffffffddddddddddddddddddddddddddbd
dbdcqgggggggggrgggggggggggggggggggcddddddddddddddddddfffffffffddddddddddddddddddddddddddbd
dbdcggggggggggrgggggbbggggggggggggcddddddddddddddddddfffffffffddddddddddddddddddddddddddbd
dbdcgggggggggrrggggbbbggggggggggggcddddddddddddddddddfffffffffddddddddddddddddddddddddddbd
dbdcgggggggggggggggggbggggggggggggcdddddddddddddddddddddddffffddddddddddddddddddddddddddbd
dbdcgggggggggggggggggbggggggggggggcdddddddddddddddddddddddffffddddddddddddddddddddddddddbd
dbdcgggggggggggggggggbggggggggggggcdddddddddcccccccccccccdffffddddddddddddddddddddddddddbd
dbdcgggggggggggggggggbggggggggggggcdddddddddchghhghhghhgcdffffdccccccccccccccdddddddddddbd
dbdcccccccccccccccccccccccggggcccccdddddddddchghhghhghhgcdffffdcsssssssssssscdddddddddddbd
dbddddddddddddddddddddddddffffddddddddddddddchghhghhghhgcdffffdcsssssssssssscdddddddddddbd
dbddddddddddddddddddddddddffffddddddddddddddchghhghhghhgcdffffdcsssssssssssscdddddddddddbd
dbddddddddddddddddddddddddffffddddddddddddddcgggggggggggccggggccbtttbssssssscdddddddddddbd
dbddddddddddddddddddddddddffffddddddddddddddcgggggggggggbgggggggggggbssssssscdddddddddddbd
dbddddddddddddddddddddddddffffddddddddddddddcbbbbbbbbggbbgggggggggggbssssssscdddddddddddbd
dbddddddddddddddddddddddddffffffffffffffffffggggggggggggggggggggggggbssssssscdddddddddddbd
dbddddddddddddddddddddddddffffffffffffffffffggggggggggggggggggggggggbssssssscdddddddddddbd
dbddddddddddddddddddddddddffffffffffffffffffgggggggggggggggggggggggggssssssscdddddddddddbd
dbddddddddddddddddddddddddffffffffffffffffffgggggggggugggggggggggggggssssssscdddddddddddbd
dbddddddddddddddddddddddddddddddffffddddddddcbbggbbbbbbbbbbbbbbbggggbssssssscdddddddddddbd
dbddddddddddddddddddddddddddddddffffddddddddcggggggggggggggggggbggggbbcccccccdddddddddddbd
dbddddddddddddddddddddddddddddddffffddddddddcggggggggggggggggggbggggggcdddddddddddddddddbd
dbddddddddddddddddddddddddddddddffffddddddddcgggggggggggggggggggggggggcdddddddddddddddddbd
dbddddddddddddddddddddddddddddddffffddddddddcgggggggggggggggggggggggggcdddddddddddddddddbd
dbddddddddddddddddddddddddddddddffffddddddddcggggggggggggggggggbggggggcdddddddddddddddddbd
dbddddddddddddddddddddddddddddddffffddddddddcggggggggggggggggggbggggggcdddddddddddddddddbd
dbddddddddddddddddddddddddddddddffffddddddddcggggggggggggcccccccggggcccdddddddddddddddddbd
dbddddddddkdddddddddddddddddddddffffddddddddcgvggggggggggcddddddffffddddddddddddddddddddbd
dbddddddddddddddddddddddddddddddffffddddddddccccccccccccccddddddffffddddddddddddddddddddbd
dbddddddddddddddddddddddddddddddffffddddddddddddddddddddddddddddffffddddddddddddddddddddbd
dbddddddddddddddddddddddddddddddffffddddddddddddddddddddddddddddffffddddddddddddddddcccccd
dbddddddddddddddddddddddddddddddffffddddddddddddddddddddddddddddffffddddddddddddddddcgggcd
dbddddddddddddddddddddddddddddddffffffffffffffddddddddddddddddddffffddddddddddddddffggggcd
dbddddddddddddddddddddddddddddddffffffffffffffddddddddddddddddddffffddddddddddddddfdcgggcd
dbddddddddddddddddddddddddddddddffffffffffffffddddddddddddddddddffffddddddddddddddfdcccccd
dbddddddddddddddddddddddddddddddffffffffffffffddddddddddddddddddffffddddddddddddddfdddbddd
dbddddddddddddddddddddddddddddddffffffffffffffffffffffffffffffffffffffffffffffffffffffbfff
dbdddddddddddddddddddddddddddddddddddddddfffffffffffffffffffffffffffffffffffffffffffffbfff
dbdddddddddddddddddddddddddddwdxdddddddddfffffffffffffffffffffffffffffffffffffffffffffbfff
dbdddddddddddddddddddddddddddddydzdddddddfffffffffffffffffffffffffffffffffffffffffffffbfff
dbdddddddddddddddddddddddddddddddddddddddfffffddddddddddddddddddddddddddddddddddddddddbddd
dbdccccccccccccccccccccccccccccccccccddddfffffddddddddddddddddddddddddddddddddddddddbbbbbd
dbdcggggggggggggggggggggggggggggggggcddddfffffddddddddddddddddddddddddddddddddddddddddddbd
dbdcggggggggggggggggggggggggggggggggcddddfffffddddddddddddddddddddddddddddddddddddddddddbd
dbdcggggggggggggggggggggbbbggbbbbggbcddddfffffddddddddddddddddddddddddddddddddddddddddddbd
dbdcgggggggggggggggggggmbgggggbgggggcddddfffffddddddddddddddddddddddddddddddddddddddddddbd
dbdcggggrrrgggrrrggggrrrbgggggbgggggcddddfffffddddcccccccccccdddddddddddddddddddddddddddbd
dbdcggggrqqgggrqqggggqqrblllggblllggcddddfffffddddcgggggggggcdddddddddddddddddddddddddddbd
dbdcggggrqqgggrqqggggqqrbgmlggbgglggcddddfffffddddcgggggggggcdddddddddddddddddddddddddddbd
dbdcqgggrqqgggrqqggggqqrbgggggbggAggcddddfffffffffgggbgggbggcdddddddddddddddddddddddddddbd
dbdcqggggggggggggggggbbbbbbbbbbbbbbbcddddfffffffffggggggggggcdddddddddddddddddddddddddddbd
dbdcqggggggggggggggggggggggggggggggggfffffffffffffgggbgggbggcdddddddddddddddddddddddddddbd
dbdcqgggrrBggggggggggggggggggggggggggfffffffffffffggggggggggcdddddddddddddddddddddddddddbd
dbdcggggrqqggggggggggggCDAgggggggEgggfffffffffddddcgggggggggcdddddddddddddddddddddddddddbd
dbdcggggFqqggggggggggggggggggggggggggfffffffffddddccccggggcccdddddddddddddddddddddddddddbd
dbdcggggBqqggggggggggbggggbbbbbssbcccddddfffffddddddddffffddddddddddddddddddddddddddddddbd
dbdcgggggggggggggggggbggggbGsssssscddddddfffffddddddddffffddddddddddddddddddddddddddddddbd
dbdcgggmgggHgggggggggbggggbsIssssscddddddfffffddddddddffffddddddddddddddddddddddddddddddbd
dbdcbggbbbbbbbbbbbbbbbggggbGJssssscddddddfffffffffffffffffddddddddddddddddddddddddddddddbd
dbdcKgggggggggggggggggggggbLsssssscddddddfffffffffffffffffddddddddddddddddddddddddddddddbd
dbdcAgggggggMgugggggggggggbsGssssscddddddfffffffffffffffffddddddddddddddddddddddddddddddbd
dbdcgmggggggggggggggggggAgbNssssOscddddddfffffffffffffffffddddddddddddddddddddddddddddddbd
dbdcggggggggggggggggggggggbGssssGscddddddfffffffffffffffffddddddddddddddddddddddddddddddbd
dbdcbbbbbbggbbbbbbbggbgggbbbbbssbbcdddddddddddddddddddddddddddddddddddddddddddddddddddddbd
dbdcggggggggbggggggggbggggggggggggcdddddddddddddddddddddddddddddddddddddddddddddddddddddbd
dbdfggggggggbggggggggbggggggggggggcdddddddddddddddddddddddddddddddddddddddddddddddddddddbd
dbdcbggbbbbbbbggbbbbbbrgggrrgggrrgcdddddddddddddddddddddddddddddddddddddddddddddddddddddbd
dbdclgggggggblgggggggbrgggrrmggrrgcdddddddddddddddddddddddddddddddddddddddddddddddddddddbd
dbdclggbPgggblgggbgggbrggKrrgggrrgcdddddddddddddddddddddddddddddddddddddddddddddddddddddbd
dbdclggbbbbbblgggbbbbbrmggrrgggrrgcdddddddddddddddddddddddddddddddddddddddddddddddddddddbd
dbdclggbggggblgggbgggbrgggrrgggrrgcdddddddddddddddddddddddddddddddddddddddddddddddddddddbd
dbdclgggggggblgggggggbggggggggggggcdddddddddddddddddddddddddddddddddddddddddddddddddddddbd
dbdcccccccccccccccccccggggggggggggfdddddddddddddddddddddddddddddddddddddddddddddddddddddbd
dbdddddddddddddddddddccccccccccccccdddddddddddddddddddddddddddddddddddddddddddddddddddddbd
dbbbbbbbbbbbbbbbbbbbbbbbbbbbbbbbbbbbbbbbbbbbbbbbbbbbbbbbbbbbbbbbbbbbbbbbbbbbbbbbbbbbbbbbbd
dddddddddddddddddddddddddddddddddddddddddddddddddddddddddddddddddddddddddddddddddddddddddd
"}
