"a" = (/obj/MapMarker/MapInfo/MapName{name = "Splatterhouse"},/turf/Floor/Sand,/area)
"b" = (/turf/Wall/Inner_Wall,/area)
"c" = (/turf/Wall/Outer_Wall,/area)
"d" = (/turf/Floor/Sand,/area)
"e" = (/obj/MapMarker/MapInfo/SupportsGameMode/DM,/turf/Floor/Sand,/area)
"f" = (/turf/Floor/DirtRoad,/area)
"g" = (/turf/Floor/Generic/Basic,/area)
"h" = (/obj/Furniture/Bed,/turf/Floor/Generic/Basic,/area)
"i" = (/obj/MapMarker/MapInfo/SupportsGameMode/EXTENDED,/turf/Floor/Sand,/area)
"j" = (/obj/MapMarker/MapInfo/SupportsGameMode/MAYHEM,/turf/Floor/Sand,/area)
"k" = (/mob/Soldier,/turf/Floor/Sand,/area)
"l" = (/obj/Furniture/Table,/turf/Floor/Generic/Basic,/area)
"m" = (/mob/Soldier,/turf/Floor/Generic/Basic,/area)
"n" = (/obj/MapMarker/MapInfo/SupportsGameMode/TDM,/turf/Floor/Sand,/area)
"o" = (/obj/MapMarker/MapInfo/Info{InfoKey = "Designed by"; InfoValue = "Sukasa"},/turf/Floor/Sand,/area)
"p" = (/obj/MapMarker/Zone/Spawn/Defenders,/turf/Floor/Generic/Basic,/area)
"q" = (/obj/Furniture/Rack,/turf/Floor/Generic/Basic,/area)
"r" = (/obj/Furniture/Table/Strong_Table,/turf/Floor/Generic/Basic,/area)
"s" = (/obj/MapMarker/Zone/Spawn/Spectator,/turf/Floor/Generic/Basic,/area)
"t" = (/obj/Machinery/Trap/PressurePlate,/turf/Floor/Generic/Basic,/area)
"u" = (/obj/Furniture/Table/Strong_Table,/obj/Item/tank,/turf/Floor/Generic/Basic,/area)
"v" = (/mob/Soldier/bot{move = 1},/turf/Floor/Generic/Basic{tag = "A"},/area)
"w" = (/obj/Item/medkit,/turf/Floor/Generic/Basic,/area)
"x" = (/obj/Item/tank,/turf/Floor/Generic/Basic{tag = "B"},/area)
"y" = (/obj/MapMarker/Zone/Spawn/Attackers,/turf/Floor/Generic/Basic,/area)
"z" = (/obj/Machinery/Trap/PressurePlate/Stealthed,/turf/Floor/Generic/Basic,/area)
"A" = (/mob/Soldier/bot{shoot = 1},/turf/Floor/Generic/Basic,/area)

(1,1,1) = {"
abbccccccccccccccccccccccccccccccccccccccccccccccccccccccccbbbbbbbbbbbbbbbbbbbbbbbbbbbbbbd
ebdfgggggggbggggggggggggggggggggggggggbhggbhggbhggbhggbhggfdddddddddddddddddddddddddddddbd
ibdfgggggggbggggggggggggggggggggggggggbgggbgggbgggbgggbgggcdddddddddddddddddddddddddddddbd
jbkcgglllgggggggggggggggggggggggggggggbgggbgggbgggbmggbgggcdddddddddddddddddddddddddddddbd
nbdcgggglgggggggggggggggggggggggggggggbmggbgggbgggbgggbgggcdddddddddddddddddddddddddddddbd
obdcgggglggbggggggggggggggggggggggggggbbbgbbbgbbbgbbbgbbbgcdddddddddddddddddddddddddddddbd
dbdcbbbbbbbbggggggggggggggggggggggggggggggggggggggggggggggcdddddddddddddddddddddddddddddbd
dbdcgggggggbggggggggggggggggggggggggggggggggggggggggggggggcdddddddddddddddddddddddddddddbd
dbdcgggggggbgggggggggggggggggbbbbbbbbbbbbbbbbbbbbbbbbbbbbbcdddddddddddddddddddddddddddddbd
dbdcgglllgggggpggggggggggggggbggggggggggggggggggggggggggggcdddddddddddddddddddddddddddddbd
dbdcgggmlggggggggggggggggggggbggggggggggggggggggggggggggggcdddddddddddddddddddddddddddddbd
dbdcgggglggbggggggggggggqqqqqbggggggggggggggggggggggggggggcdddddddddddddddddddddddddddddbd
dbdcbbbbbbbbbbbbggggbbbbbbbbbbggggggggggggggggggggggggggggcdddddddddddddddddddddddddddddbd
dbdcqqqqggggggrgggggggggggggggggggcccccccccccccccccccggggccdddddddddddddddddddddddddddddbd
dbdcqqggggggggrgggggggggggggggggggcddddddddddddddddddffffdddddddddddddddddddddddddddddddbd
dbdcqgggggggggrgggggggggggggggggggcddddddddddddddddddfffffffffddddddddddddddddddddddddddbd
dbdcqgggggggggrgggggggggggggggggggcddddddddddddddddddfffffffffddddddddddddddddddddddddddbd
dbdcggggggggggrgggggbbggggggggggggcddddddddddddddddddfffffffffddddddddddddddddddddddddddbd
dbdcgggggggggrrggggbbbggggggggggggcddddddddddddddddddfffffffffddddddddddddddddddddddddddbd
dbdcgggggggggggggggggbggggggggggggcdddddddddddddddddddddddffffddddddddddddddddddddddddddbd
dbdcgggggggggggggggggbggggggggggggcdddddddddddddddddddddddffffddddddddddddddddddddddddddbd
dbdcgggggggggggggggggbggggggggggggcdddddddddcccccccccccccdffffddddddddddddddddddddddddddbd
dbdcgggggggggggggggggbggggggggggggcdddddddddchghhghhghhgcdffffdccccccccccccccdddddddddddbd
dbdcccccccccccccccccccccccggggcccccdddddddddchghhghhghhgcdffffdcggggggggggggcdddddddddddbd
dbddddddddddddddddddddddddffffddddddddddddddchghhghhghhgcdffffdcggggggggggggcdddddddddddbd
dbddddddddddddddddddddddddffffddddddddddddddchghhghhghhgcdffffdcggggggggggggcdddddddddddbd
dbddddddddddddddddddddddddffffddddddddddddddcgggggggggggccggggccbrrrbgggggggcdddddddddddbd
dbddddddddddddddddddddddddffffddddddddddddddcgggggggggggbgggggggggggbgggggggcdddddddddddbd
dbddddddddddddddddddddddddffffddddddddddddddcbbbbbbbbggbbgggggggggggbgggggggcdddddddddddbd
dbddddddddddddddddddddddddffffffffffffffffffggggggggggggggggggggggggbgggggggcdddddddddddbd
dbddddddddddddddddddddddddffffffffffffffffffggggggggggggggggggggggggbgggggggcdddddddddddbd
dbddddddddddddddddddddddddffffffffffffffffffggggggggggggggggggggggggggggggggcdddddddddddbd
dbddddddddddddddddddddddddffffffffffffffffffggggggggggggggggggggggggggggggggcdddddddddddbd
dbddddddddddddddddddddddddddddddffffddddddddcbbggbbbbbbbbbbbbbbbggggbgggggggcdddddddddddbd
dbddddddddddddddddddddddddddddddffffddddddddcggggggggggggggggggbggggbbcccccccdddddddddddbd
dbddddddddddddddddddddddddddddddffffddddddddcggggggggggggggggggbggggggcdddddddddddddddddbd
dbddddddddddddddddddddddddddddddffffddddddddcgggggggggggggggggggggggggcdddddddddddddddddbd
dbddddddddddddddddddddddddddddddffffddddddddcgggggggggggggggggggggggggcdddddddddddddddddbd
dbddddddddddddddddddddddddddddddffffddddddddcggggggggggggggggggbggggggcdddddddddddddddddbd
dbddddddddddddddddddddddddddddddffffddddddddcggggggggggggggggggbggggggcdddddddddddddddddbd
dbddddddddddddddddddddddddddddddffffddddddddcggggggggggggcccccccggggcccdddddddddddddddddbd
dbddddddddkdddddddddddddddddddddffffddddddddcgsggggggggggcddddddffffddddddddddddddddddddbd
dbddddddddddddddddddddddddddddddffffddddddddccccccccccccccddddddffffddddddddddddddddddddbd
dbddddddddddddddddddddddddddddddffffddddddddddddddddddddddddddddffffddddddddddddddddddddbd
dbddddddddddddddddddddddddddddddffffddddddddddddddddddddddddddddffffddddddddddddddddcccccd
dbddddddddddddddddddddddddddddddffffddddddddddddddddddddddddddddffffddddddddddddddddcgggcd
dbddddddddddddddddddddddddddddddffffffffffffffddddddddddddddddddffffddddddddddddddffggggcd
dbddddddddddddddddddddddddddddddffffffffffffffddddddddddddddddddffffddddddddddddddfdcgggcd
dbddddddddddddddddddddddddddddddffffffffffffffddddddddddddddddddffffddddddddddddddfdcccccd
dbddddddddddddddddddddddddddddddffffffffffffffddddddddddddddddddffffddddddddddddddfdddbddd
dbddddddddddddddddddddddddddddddffffffffffffffffffffffffffffffffffffffffffffffffffffffbfff
dbdddddddddddddddddddddddddddddddddddddddfffffffffffffffffffffffffffffffffffffffffffffbfff
dbdddddddddddddddddddddddddddddddddddddddfffffffffffffffffffffffffffffffffffffffffffffbfff
dbdddddddddddddddddddddddddddddddddddddddfffffffffffffffffffffffffffffffffffffffffffffbfff
dbdddddddddddddddddddddddddddddddddddddddfffffddddddddddddddddddddddddddddddddddddddddbddd
dbdccccccccccccccccccccccccccccccccccddddfffffddddddddddddddddddddddddddddddddddddddbbbbbd
dbdcggggggggggggggggggggggggggggggggcddddfffffddddddddddddddddddddddddddddddddddddddddddbd
dbdcggggggggggggggggggggggggggggggggcddddfffffddddddddddddddddddddddddddddddddddddddddddbd
dbdcggggggggggggggggggggbbbggbbbbggbcddddfffffddddddddddddddddddddddddddddddddddddddddddbd
dbdcgggggggggggggggggggmbgggggbgggggcddddfffffddddddddddddddddddddddddddddddddddddddddddbd
dbdcggggrrrgggrrrggggrrrbgggggbgggggcddddfffffddddcccccccccccdddddddddddddddddddddddddddbd
dbdcggggrqqgggrqqggggqqrblllggblllggcddddfffffddddcgggggggggcdddddddddddddddddddddddddddbd
dbdcggggrqqgggrqqggggqqrbgmlggbgglggcddddfffffddddcgggggggggcdddddddddddddddddddddddddddbd
dbdcqgggrqqgggrqqggggqqrbgggggbggtggcddddfffffffffgggbgggbggcdddddddddddddddddddddddddddbd
dbdcqggggggggggggggggbbbbbbbbbbbbbbbcddddfffffffffggggggggggcdddddddddddddddddddddddddddbd
dbdcqggggggggggggggggggggggggggggggggfffffffffffffgggbgggbggcdddddddddddddddddddddddddddbd
dbdcqgggrruggggggggggggggggggggggggggfffffffffffffggggggggggcdddddddddddddddddddddddddddbd
dbdcggggrqqggggggggggggvwtgggggggxgggfffffffffddddcgggggggggcdddddddddddddddddddddddddddbd
dbdcggggrqqggggggggggggggggggggggggggfffffffffddddccccggggcccdddddddddddddddddddddddddddbd
dbdcgggguqqggggggggggbggggbbbbbggbcccddddfffffddddddddffffddddddddddddddddddddddddddddddbd
dbdcgggggggggggggggggbggggbgggggggcddddddfffffddddddddffffddddddddddddddddddddddddddddddbd
dbdcgggmgggygggggggggbggggbgggggggcddddddfffffddddddddffffddddddddddddddddddddddddddddddbd
dbdcbggbbbbbbbbbbbbbbbggggbgggggggcddddddfffffffffffffffffddddddddddddddddddddddddddddddbd
dbdczgggggggggggggggggggggbgggggggcddddddfffffffffffffffffddddddddddddddddddddddddddddddbd
dbdctgggggggggggggggggggggbgggggggcddddddfffffffffffffffffddddddddddddddddddddddddddddddbd
dbdcgmggggggggggggggggggtgbgggggggcddddddfffffffffffffffffddddddddddddddddddddddddddddddbd
dbdcggggggggggggggggggggggbgggggggcddddddfffffffffffffffffddddddddddddddddddddddddddddddbd
dbdcbbbbbbggbbbbbbbggbgggbbbbbggbbcdddddddddddddddddddddddddddddddddddddddddddddddddddddbd
dbdcggggggggbggggggggbggggggggggggcdddddddddddddddddddddddddddddddddddddddddddddddddddddbd
dbdfggggggggbggggggggbggggggggggggcdddddddddddddddddddddddddddddddddddddddddddddddddddddbd
dbdcbggbbbbbbbggbbbbbbrgggrrgggrrgcdddddddddddddddddddddddddddddddddddddddddddddddddddddbd
dbdclgggggggblgggggggbrgggrrmggrrgcdddddddddddddddddddddddddddddddddddddddddddddddddddddbd
dbdclggbAgggblgggbgggbrggzrrgggrrgcdddddddddddddddddddddddddddddddddddddddddddddddddddddbd
dbdclggbbbbbblgggbbbbbrmggrrgggrrgcdddddddddddddddddddddddddddddddddddddddddddddddddddddbd
dbdclggbggggblgggbgggbrgggrrgggrrgcdddddddddddddddddddddddddddddddddddddddddddddddddddddbd
dbdclgggggggblgggggggbggggggggggggcdddddddddddddddddddddddddddddddddddddddddddddddddddddbd
dbdcccccccccccccccccccggggggggggggfdddddddddddddddddddddddddddddddddddddddddddddddddddddbd
dbdddddddddddddddddddccccccccccccccdddddddddddddddddddddddddddddddddddddddddddddddddddddbd
dbbbbbbbbbbbbbbbbbbbbbbbbbbbbbbbbbbbbbbbbbbbbbbbbbbbbbbbbbbbbbbbbbbbbbbbbbbbbbbbbbbbbbbbbd
dddddddddddddddddddddddddddddddddddddddddddddddddddddddddddddddddddddddddddddddddddddddddd
"}
