"aa" = (/obj/MapMarker/MapInfo/MapName{name = "Splatterhouse"},/turf/Floor/Sand,/area)
"ab" = (/turf/Wall/Inner_Wall,/area)
"ac" = (/turf/Wall/Outer_Wall,/area)
"ad" = (/turf/Floor/Sand,/area)
"ae" = (/obj/MapMarker/MapInfo/SupportsGameMode/DM,/turf/Floor/Sand,/area)
"af" = (/turf/Floor/DirtRoad,/area)
"ag" = (/turf/Floor/Generic/Basic,/area)
"ah" = (/obj/Furniture/Bed,/turf/Floor/Generic/Basic,/area)
"ai" = (/obj/MapMarker/MapInfo/SupportsGameMode/EXTENDED,/turf/Floor/Sand,/area)
"aj" = (/obj/MapMarker/MapInfo/SupportsGameMode/MAYHEM,/turf/Floor/Sand,/area)
"ak" = (/mob/Soldier,/turf/Floor/Sand,/area)
"al" = (/obj/Furniture/Table,/turf/Floor/Generic/Basic,/area)
"am" = (/mob/Soldier,/turf/Floor/Generic/Basic,/area)
"an" = (/obj/MapMarker/MapInfo/SupportsGameMode/TDM,/turf/Floor/Sand,/area)
"ao" = (/obj/MapMarker/MapInfo/Info{InfoKey = "Designed by"; InfoValue = "Sukasa"},/turf/Floor/Sand,/area)
"ap" = (/obj/MapMarker/Zone/Spawn/Defenders,/turf/Floor/Generic/Basic,/area)
"aq" = (/obj/Furniture/Rack,/obj/Item/Ranged/Stunner,/turf/Floor/Generic/Basic,/area)
"ar" = (/obj/Furniture/Rack,/turf/Floor/Generic/Basic,/area)
"as" = (/obj/Furniture/Table/Strong_Table,/turf/Floor/Generic/Basic,/area)
"at" = (/turf/Floor/Generic/Lab,/area)
"au" = (/obj/Item/canister,/turf/Floor/Generic/Basic,/area)
"av" = (/obj/Furniture/Table/Strong_Table,/turf/Floor/Generic/Lab,/area)
"aw" = (/obj/Container/WoodCrate{step_x = 0},/turf/Floor/Generic/Basic,/area)
"ax" = (/obj/Container/WoodCrate{step_x = 16; step_y = 0},/turf/Floor/Generic/Basic,/area)
"ay" = (/obj/Container/WoodCrate{step_x = 30; step_y = -7},/turf/Floor/Generic/Basic,/area)
"az" = (/obj/Machinery/Trap/PressurePlate/Stealthed,/turf/Floor/Generic/Basic,/area)
"aA" = (/obj/Furniture/Rack,/obj/Item/medkit,/turf/Floor/Generic/Basic,/area)
"aB" = (/obj/Container/WoodCrate{step_x = 28; step_y = 19},/turf/Floor/Generic/Basic,/area)
"aC" = (/obj/Furniture/Table,/obj/Item/tank,/turf/Floor/Generic/Lab,/area)
"aD" = (/obj/Item/canister,/turf/Floor/Sand,/area)
"aE" = (/obj/Furniture/Bed,/turf/Floor/Generic/Lab,/area)
"aF" = (/obj/Furniture/Table,/obj/Item/tank,/turf/Floor/Generic/Basic,/area)
"aG" = (/obj/MapMarker/Zone/Spawn/Spectator,/turf/Floor/Generic/Basic,/area)
"aH" = (/obj/Furniture/Table,/turf/Floor/Generic/Lab,/area)
"aI" = (/obj/Container/WoodCrate{step_x = 29; step_y = -2},/turf/Floor/Sand,/area)
"aJ" = (/obj/Container/WoodCrate{step_x = 28; step_y = 19},/turf/Floor/Sand,/area)
"aK" = (/obj/Container/WoodCrate{step_x = 0; step_y = 0},/turf/Floor/Sand,/area)
"aL" = (/obj/Item/canister{step_x = 28; step_y = 25},/turf/Floor/Sand,/area)
"aM" = (/obj/Container/WoodCrate{step_x = 21; step_y = 19},/turf/Floor/Sand,/area)
"aN" = (/obj/Machinery/Trap/PressurePlate,/turf/Floor/Generic/Basic,/area)
"aO" = (/obj/Furniture/Table/Strong_Table,/obj/Item/tank,/turf/Floor/Generic/Basic,/area)
"aP" = (/mob/Soldier/bot{move = 1},/turf/Floor/Generic/Basic{tag = "A"},/area)
"aQ" = (/obj/Item/medkit,/turf/Floor/Generic/Basic,/area)
"aR" = (/obj/Item/tank,/turf/Floor/Generic/Basic{tag = "B"},/area)
"aS" = (/obj/Furniture/Table/Strong_Table{step_x = 0; step_y = 0},/turf/Floor/Generic/Basic,/area)
"aT" = (/obj/Container/WoodCrate,/turf/Floor/Generic/Lab,/area)
"aU" = (/obj/MapMarker/Zone/Spawn/Attackers,/turf/Floor/Generic/Basic,/area)
"aV" = (/obj/Container/WoodCrate{step_x = 22; step_y = 20},/turf/Floor/Generic/Lab,/area)
"aW" = (/obj/Container/WoodCrate{step_x = 31; step_y = 10},/turf/Floor/Generic/Lab,/area)
"aX" = (/obj/Item/medkit,/obj/Container/WoodCrate{step_x = 16; step_y = 0},/turf/Floor/Generic/Lab,/area)
"aY" = (/obj/Container/WoodCrate{step_x = 20; step_y = 16},/turf/Floor/Generic/Basic,/area)
"aZ" = (/obj/Container/WoodCrate{step_x = 22; step_y = 0},/turf/Floor/Generic/Lab,/area)
"ba" = (/obj/Container/WoodCrate{step_x = 12; step_y = 7},/turf/Floor/Generic/Lab,/area)
"bb" = (/mob/Soldier/bot{shoot = 1},/turf/Floor/Generic/Basic,/area)

(1,1,1) = {"
aaababacacacacacacacacacacacacacacacacacacacacacacacacacacacacacacacacacacacacacacacacacacacacacacacacacacacacacacacacababababababababababababababababababababababababababababababad
aeabadafagagagagagagagabagagagagagagagagagagagagagagagagagagagagagagagagagagabahagagabahagagabahagagabahagagabahagagafadadadadadadadadadadadadadadadadadadadadadadadadadadadadadabad
aiabadafagagagagagagagabagagagagagagagagagagagagagagagagagagagagagagagagagagabagagagabagagagabagagagabagagagabagagagacadadadadadadadadadadadadadadadadadadadadadadadadadadadadadabad
ajabakacagagalalalagagagagagagagagagagagagagagagagagagagagagagagagagagagagagabagagagabagagagabagagagabamagagabagagagacadadadadadadadadadadadadadadadadadadadadadadadadadadadadadabad
anabadacagagagagalagagagagagagagagagagagagagagagagagagagagagagagagagagagagagabamagagabagagagabagagagabagagagabagagagacadadadadadadadadadadadadadadadadadadadadadadadadadadadadadabad
aoabadacagagagagalagagabagagagagagagagagagagagagagagagagagagagagagagagagagagabababagabababagabababagabababagabababagacadadadadadadadadadadadadadadadadadadadadadadadadadadadadadabad
adabadacababababababababagagagagagagagagagagagagagagagagagagagagagagagagagagagagagagagagagagagagagagagagagagagagagagacadadadadadadadadadadadadadadadadadadadadadadadadadadadadadabad
adabadacagagagagagagagabagagagagagagagagagagagagagagagagagagagagagagagagagagagagagagagagagagagagagagagagagagagagagagacadadadadadadadadadadadadadadadadadadadadadadadadadadadadadabad
adabadacagagagagagagagabagagagagagagagagagagagagagagagagagabababababababababababababababababababababababababababababacadadadadadadadadadadadadadadadadadadadadadadadadadadadadadabad
adabadacagagalalalagagagagagapagagagagagagagagagagagagagagabagagagagagagagagagagagagagagagagagagagagagagagagagagagagacadadadadadadadadadadadadadadadadadadadadadadadadadadadadadabad
adabadacagagagamalagagagagagagagagagagagagagagagagagagagagabagagagagagagagagagagagagagagagagagagagagagagagagagagagagacadadadadadadadadadadadadadadadadadadadadadadadadadadadadadabad
adabadacagagagagalagagabagagagagagagagagagagagagaqaqaqaqaqabagagagagagagagagagagagagagagagagagagagagagagagagagagagagacadadadadadadadadadadadadadadadadadadadadadadadadadadadadadabad
adabadacababababababababababababagagagagababababababababababagagagagagagagagagagagagagagagagagagagagagagagagagagagagacadadadadadadadadadadadadadadadadadadadadadadadadadadadadadabad
adabadacararararagagagagagagasagagagagagagagagagagagagagagagagagagagacacacacacacacacacacacacacacacacacacacatatatatacacadadadadadadadadadadadadadadadadadadadadadadadadadadadadadabad
adabadacararagagagagagagagagasagagagagagagagagagagagagagagagagagagagacadadadadadadadadadadadadadadadadadadafafafafadadadadadadadadadadadadadadadadadadadadadadadadadadadadadadadabad
adabadacaragagagagagagagagagasagagagagagagagagagagagagagagagagagagagacadadadadadadadadadadadadadadadadadadafafafafafafafafafadadadadadadadadadadadadadadadadadadadadadadadadadadabad
adabadacaragagagagagagagagagasagagagagagagagagagagagagagagagagagagagacadadadadadadadadadadadadadadadadadadafafafafafafafafafadadadadadadadadadadadadadadadadadadadadadadadadadadabad
adabadacagagagagagagagagagagasagagagagagababagagagagagagagagagagagagacadadadadadadadadadadadadadadadadadadafafafafafafafafafadadadadadadadadadadadadadadadadadadadadadadadadadadabad
adabadacagagagagagagagagagasasagagagagabababagagagagagagagagagagagagacadadadadadadadadadadadadadadadadadadafafafafafafafafafadadadadadadadadadadadadadadadadadadadadadadadadadadabad
adabadacagagagagagagagagagagagagagagagagagabagagagagagagagagagagagauacadadadadadadadadadadadadadadadadadadadadadadadafafafafadadadadadadadadadadadadadadadadadadadadadadadadadadabad
adabadacagagagagagagagagagagagagagagagagagabagagagagagagagagagagagauacadadadadadadadadadadadadadadadadadadadadadadadafafafafadadadadadadadadadadadadadadadadadadadadadadadadadadabad
adabadacagagagagagagagagagagagagagagagagagabagagagagagagagagagagagauacadadadadadadadadadacacacacacacacacacacacacacadafafafafadadadadadadadadadadadadadadadadadadadadadadadadadadabad
adabadacagagagagagagagagagagagagagagagagagabagagagagagagagagagagagauacadadadadadadadadadacahagahahagahahagahahagacadafafafafadacacacacacacacacacacacacacacadadadadadadadadadadadabad
adabadacacacacacacacacacacacacacacacacacacacacacacacatatatatacacacacacadadadadadadadadadacahagahahagahahagahahagacadafafafafadacatatatatatatatatatatatatacadadadadadadadadadadadabad
adabadadadadadadadadadadadadadadadadadadadadadadadadafafafafadadadadadadadadadadadadadadacahagahahagahahagahahagacadafafafafadacatatatatatatatatatatatatacadadadadadadadadadadadabad
adabadadadadadadadadadadadadadadadadadadadadadadadadafafafafadadadadadadadadadadadadadadacahagahahagahahagahahagacadafafafafadacatatatatatatatatatatatatacadadadadadadadadadadadabad
adabadadadadadadadadadadadadadadadadadadadadadadadadafafafafadadadadadadadadadadadadadadacagagagagagagagagagagagacacatatatatacacabavavavabatatatatatatatacadadadadadadadadadadadabad
adabadadadadadadadadadadadadadadadadadadadadadadadadafafafafadadadadadadadadadadadadadadacagagagagagagagagagagagabagagagagagagagagagagagabatatatatatatatacadadadadadadadadadadadabad
adabadadadadadacacacacacacacacacacacacacacacacadadadafafafafadadadadadadadadadadadadadadacababababababababagagababagagagagagagagagagagagabatatatatatatatacadadadadadadadadadadadabad
adabadadadadadacawaxagawayagagawagagagagagagatafafafafafafafafafafafafafafafafafafafafafatagagagagagagagagagagagagagagagagagagagagagagagabatatatatatatatacadadadadadadadadadadadabad
adabadadadadadacagagagagagagagagagagagagagagatafafafafafafafafafafafafafafafafafafafafafatagagagagagagagagagagagagagagagagagagagagagagagabatatatatatatatacadadadadadadadadadadadabad
adabadadadadadacagagagagazagagagagagagagagagatafafafafafafafafafafafafafafafafafafafafafatagagagagagagagagagagagagagagagagagagagagagagagagatatatatatatatacadadadadadadadadadadadabad
adabadadadadadacabababagagagagaAaAaAaAagagagacadadadafafafafafafafafafafafafafafafafafafatagagagagagagagagaBagagagagagagagagagagagagagagagatatatatatatatacadadadadadadadadadadadabad
adabadadadadadacaCaCabagagagagababababagagabacadadadadadadadadadafafafafadadadadadadadadacababagagabababababababababababababababagagagagabatatatatatatatacadadadadadadadadadadadabad
adabadadadadadacatatatagagagagabawagagagagagacadadadadadadadadadafafafafadadadadadadadadacagagagagagagagagagagagagagagagagagagabagagagagababacacacacacacacadadadadadadadadadadadabad
adabadadadadadacatatatagagagagabagagagagagagacaDadadadadadadadadafafafafadadadadadadadadacagagagagagagagagagagagagagagagagagagabagagagagagagacadadadadadadadadadadadadadadadadadabad
adabadadadadadacaEatabagagagagagagagagagagagacacacacacacacadadadafafafafadadadadadadadadacagagagagagagagagagagagagagagagagagagagagagagagagagacadadadadadadadadadadadadadadadadadabad
adabadadadadadacatatabagagagagagagagagagagazagagalalalalacadadadafafafafadadadadadadadadacagagagagagagagagagagagagagagagagagagagagagagagagagacadadadadadadadadadadadadadadadadadabad
adabadadadadadacaEatabagagagagabalagagagagagagagagagagalacadadadafafafafadadadadadadadadacagagagagagagagagagagagagagagagagagagabagagagagagagacadadadadadadadadadadadadadadadadadabad
adabadadadadadacatatabagagagagabalalalalagagagagagagagaFacadadadafafafafadadadadadadadadacagagagagagagagagagagagagagagagagagagabagagagagagagacadadadadadadadadadadadadadadadadadabad
adabadadadadadacaEatabagagagagabababababababababagagababacadadadafafafafadadadadadadadadacagagagagagagagagagagagagacacacacacacacatatatatacacacadadadadadadadadadadadadadadadadadabad
adabadadadadadacatatatagagagagagagagagagagawagagagagagagatafafafafafafafadadadadadadadadacagaGagagagagagagagagagagacadadadadadadafafafafadadadadadadadadadadadadadadadadadadadadabad
adabadadadadadacatatatagagagagagagagagagagagagagagagagagatafafafafafafafadadadadadadadadacacacacacacacacacacacacacacadadadadadadafafafafadadadadadadadadadadadadadadadadadadadadabad
adabadadadadadacatatabagagagagagagagagagagagagagagagagagatafafafafafafafadadadadadadadadadadadadadadadadadadadadadadadadadadadadafafafafadadadadadadadadadadadadadadadadadadadadabad
adabadadadadadacaHaHabagagagagagagawagagagagagagagagagagacadadadafafafafadadadadadadadadadadadadadadadadadadadadadadadadadadadadafafafafadadadadadadadadadadadadadadadadacacacacacad
adabadadadadadacacacacacatatatacacacacacacacacacacacacacacadadadafafafafadadadadadadadadadadadadadadadadadadadadadadadadadadadadafafafafadadadadadadadadadadadadadadadadacagagagacad
adabadadadadadadadadadadafafafadadadadadadadadadadadadadadadadadafafafafafafafafafafafafafafadadadadadadadadadadadadadadadadadadafafafafadadadadadadadadadadadadadadafafatagagagacad
adabadadadadadadadadadadafafafadadadadadadadadadadadadadadadadadafafafafafafafafafafafafafafadadadadadadadadadadadadadadadadadadafafafafadadadadadadadadadadadadadadafadacagagagacad
adabadadadadadadadadadadafafafadadadadadadadadadadadadadadadadadafafafafafafafafafafafafafafadadadadadadadadadadadadadadadadadadafafafafadadadadadadadadadadadadadadafadacacacacacad
adabadadadadadadadadadadafafafafafafafafafafafafafafafafafafafafafafafafafafafafafafafafafafadadadadadadadadadadadadadadadadadadafafafafadadadadadadadadadadadadadadafadadadabadadad
adabadadadadadadadadadadafafafafafafafafafafafafafafafafafafafafafafafafafafafafafafafafafafafafafafafafafafafafafafafafafafafafafafafafafafafafafafafafafafafafafafafafafafabafafaf
adabadadadadadadadadadadafafafadadadadadadadadadadadadadadadadadadadadadadadadadadafafafafafafafafafafafafafafafafafafafafafafafafafafafafafafafafafafafafafafafafafafafafafabafafaf
adabadadadadadadadadadadafafafadadadadadadadadadadadadadadaIadaJadadadadadadadadadafafafafafafafafafafafafafafafafafafafafafafafafafafafafafafafafafafafafafafafafafafafafafabafafaf
adabadadadadadadadadadadafafafadadadadadadadadadadadadadadadadaKaLaMadadadadadadadafafafafafafafafafafafafafafafafafafafafafafafafafafafafafafafafafafafafafafafafafafafafafabafafaf
adabadadadadadadadadadadafafafadadadadadadadadadadadadadadadadaDadadadadadadadadadafafafafafadadadadadadadadadadadadadadadadadadadadadadadadadadadadadadadadadadadadadadadadabadadad
adabadacacacacacacacacacatatatacacacacacacacacacacacacacacacacacacacacacacadadadadafafafafafadadadadadadadadadadadadadadadadadadadadadadadadadadadadadadadadadadadadadadabababababad
adabadacagagagagagagagagagagagagagagagagagagagagagagagagagagagagagagagagacadadadadafafafafafadadadadadadadadadadadadadadadadadadadadadadadadadadadadadadadadadadadadadadadadadadabad
adabadacagagagagagagagagagagagagagagagagagagagagagagagagagagagagagagagagacadadadadafafafafafadadadadadadadadadadadadadadadadadadadadadadadadadadadadadadadadadadadadadadadadadadabad
adabadacagagagagagagagagagagagagagagagagagagagagabababagagababababagagabacadadadadafafafafafadadadadadadadadadadadadadadadadadadadadadadadadadadadadadadadadadadadadadadadadadadabad
adabadacagagagagagagagagagagagagagagagagagagagamabagagagagagabagagagagagacadadadadafafafafafadadadadadadadadadadadadadadadadadadadadadadadadadadadadadadadadadadadadadadadadadadabad
adabadacagagagagasasasagagagasasasagagagagasasasabagagagagagabagagagagagacadadadadafafafafafadadadadacacacacacacacacacacacadadadadadadadadadadadadadadadadadadadadadadadadadadadabad
adabadacagagagagasararagagagasararagagagagararasabalalalagagabalalalagagacadadadadafafafafafadadadadacagagagagagagagagagacadadadadadadadadadadadadadadadadadadadadadadadadadadadabad
adabadacagagagagasararagagagasararagagagagararasabagamalagagabagagalagagacadadadadafafafafafadadadadacagagagagagagagagagacadadadadadadadadadadadadadadadadadadadadadadadadadadadabad
adabadacaragagagasararagagagasararagagagagararasabagagagagagabagagaNagagacadadadadafafafafafafafafafatagagabagagagabagagacadadadadadadadadadadadadadadadadadadadadadadadadadadadabad
adabadacaragagagagagagagagagagagagagagagagabababababababababababababababacadadadadafafafafafafafafafatagagasagagagasagagacadadadadadadadadadadadadadadadadadadadadadadadadadadadabad
adabadacaragagagagagagagagagagagagagagagagagagagagagagagagagagagagagagagatafafafafafafafafafafafafafatagagabasasasabagagacadadadadadadadadadadadadadadadadadadadadadadadadadadadabad
adabadacaragagagasasaOagagagagagagagagagagagagagagagagagagagagagagagagagatafafafafafafafafafafafafafatagagagagagagagagagacadadadadadadadadadadadadadadadadadadadadadadadadadadadabad
adabadacagagagagasararagagagagagagagagagagagagaPaQagagagagagagagagaRagagatafafafafafafafafafadadadadacagagagagagagagagagacadadadadadadadadadadadadadadadadadadadadadadadadadadadabad
adabadacagagagagaSararagagagagagagagagagagagagagagagagagagagagagagagagagatafafafafafafafafafadadadadacacacacatatatatacacacadadadadadadadadadadadadadadadadadadadadadadadadadadadabad
adabadacagagagagaOararagagagagagagagagagagabagagagagabababababatatabacacacadadadadafafafafafadadadadadadadadafafafafadadadadadadadadadadadadadadadadadadadadadadadadadadadadadadabad
adabadacagagagagagagagagagagagagagagagagagabagagagagabaTatatatatatatacadadadadadadafafafafafadadadadadadadadafafafafadadadadadadadadadadadadadadadadadadadadadadadadadadadadadadabad
adabadacagagagamagagagaUagagagagagagagagagabagagagagabataVatatatatatacadadadadadadafafafafafadadadadadadadadafafafafadadadadadadadadadadadadadadadadadadadadadadadadadadadadadadabad
adabadacabagagabababababababababababababababagagagagabaTaWatatatatatacadadadadadadafafafafafafafafafafafafafafafafafadadadadadadadadadadadadadadadadadadadadadadadadadadadadadadabad
adabadacagagagagagagagagagagagagagagagagagagagagagagabaXatatatatatatacadadadadadadafafafafafafafafafafafafafafafafafadadadadadadadadadadadadadadadadadadadadadadadadadadadadadadabad
adabadacagagagagagagagagaYagaBagagagagagagagagagagagabataTatatatatatacadadadadadadafafafafafafafafafafafafafafafafafadadadadadadadadadadadadadadadadadadadadadadadadadadadadadadabad
adabadacagamagagagagagagagagagagagagagagagagagagagagabaZatatatatbaatacadadadadadadafafafafafafafafafafafafafafafafafadadadadadadadadadadadadadadadadadadadadadadadadadadadadadadabad
adabadacagagagagagagagagagagagagagagagagagagagagagagabaTatatatataTatacadadadadadadafafafafafafafafafafafafafafafafafadadadadadadadadadadadadadadadadadadadadadadadadadadadadadadabad
adabadacababababababagagabababababababagagabagagagabababababatatababacadadadadadadadadadadadadadadadadadadadadadadadadadadadadadadadadadadadadadadadadadadadadadadadadadadadadadabad
adabadacagagagagagagagagabagagagagagagagagabagagagagagagagagagagagagacadadadadadadadadadadadadadadadadadadadadadadadadadadadadadadadadadadadadadadadadadadadadadadadadadadadadadabad
adabadafagagagagagagagagabagagagagagagagagabagagagagagagagagagagagagacadadadadadadadadadadadadadadadadadadadadadadadadadadadadadadadadadadadadadadadadadadadadadadadadadadadadadabad
adabadacabagagabababababababagagababababababasagagagasasagagagasasagacadadadadadadadadadadadadadadadadadadadadadadadadadadadadadadadadadadadadadadadadadadadadadadadadadadadadadabad
adabadacalagagagagagagagabalagagagagagagagabasagagagasasamagagasasagacadadadadadadadadadadadadadadadadadadadadadadadadadadadadadadadadadadadadadadadadadadadadadadadadadadadadadabad
adabadacalagagabbbagagagabalagagagabagagagabasagagazasasagagagasasagacadadadadadadadadadadadadadadadadadadadadadadadadadadadadadadadadadadadadadadadadadadadadadadadadadadadadadabad
adabadacalagagababababababalagagagabababababasamagagasasagagagasasagacadadadadadadadadadadadadadadadadadadadadadadadadadadadadadadadadadadadadadadadadadadadadadadadadadadadadadabad
adabadacalagagabagagagagabalagagagabagagagabasagagagasasagagagasasagacadadadadadadadadadadadadadadadadadadadadadadadadadadadadadadadadadadadadadadadadadadadadadadadadadadadadadabad
adabadacalagagagagagagagabalagagagagagagagabagagagagagagagagagagagagacadadadadadadadadadadadadadadadadadadadadadadadadadadadadadadadadadadadadadadadadadadadadadadadadadadadadadabad
adabadacacacacacacacacacacacacacacacacacacacagagagagagagagagagagagagafadadadadadadadadadadadadadadadadadadadadadadadadadadadadadadadadadadadadadadadadadadadadadadadadadadadadadabad
adabadadadadadadadadadadadadadadadadadadadacacacacacacacacacacacacacacadadadadadadadadadadadadadadadadadadadadadadadadadadadadadadadadadadadadadadadadadadadadadadadadadadadadadabad
adababababababababababababababababababababababababababababababababababababababababababababababababababababababababababababababababababababababababababababababababababababababababad
adadadadadadadadadadadadadadadadadadadadadadadadadadadadadadadadadadadadadadadadadadadadadadadadadadadadadadadadadadadadadadadadadadadadadadadadadadadadadadadadadadadadadadadadadad
"}
