"a" = (/turf/Floor/Sand,/area)
"b" = (/turf/Wall/Inner_Wall,/area)
"c" = (/turf/Wall/Outer_Wall,/area)
"d" = (/turf/Floor/DirtRoad,/area)
"e" = (/turf/Floor/Generic/Basic,/area)
"f" = (/obj/Furniture/Bed,/turf/Floor/Generic/Basic,/area)
"g" = (/mob/Soldier,/turf/Floor/Sand,/area)
"h" = (/obj/Furniture/Table,/turf/Floor/Generic/Basic,/area)
"i" = (/mob/Soldier,/turf/Floor/Generic/Basic,/area)
"j" = (/obj/Furniture/Rack,/turf/Floor/Generic/Basic,/area)
"k" = (/obj/Furniture/Table/Strong_Table,/turf/Floor/Generic/Basic,/area)

(1,1,1) = {"
abbccccccccccccccccccccccccccccccccccccccccccccccccccccccccbbbbbbbbbbbbbbbbbbbbbbbbbbbbbba
abadeeeeeeebeeeeeeeeeeeeeeeeeeeeeeeeeebfeebfeebfeebfeebfeedaaaaaaaaaaaaaaaaaaaaaaaaaaaaaba
abadeeeeeeebeeeeeeeeeeeeeeeeeeeeeeeeeebeeebeeebeeebeeebeeecaaaaaaaaaaaaaaaaaaaaaaaaaaaaaba
abgceehhheeeeeeeeeeeeeeeeeeeeeeeeeeeeebeeebeeebeeebieebeeecaaaaaaaaaaaaaaaaaaaaaaaaaaaaaba
abaceeeeheeeeeeeeeeeeeeeeeeeeeeeeeeeeebieebeeebeeebeeebeeecaaaaaaaaaaaaaaaaaaaaaaaaaaaaaba
abaceeeeheebeeeeeeeeeeeeeeeeeeeeeeeeeebbbebbbebbbebbbebbbecaaaaaaaaaaaaaaaaaaaaaaaaaaaaaba
abacbbbbbbbbeeeeeeeeeeeeeeeeeeeeeeeeeeeeeeeeeeeeeeeeeeeeeecaaaaaaaaaaaaaaaaaaaaaaaaaaaaaba
abaceeeeeeebeeeeeeeeeeeeeeeeeeeeeeeeeeeeeeeeeeeeeeeeeeeeeecaaaaaaaaaaaaaaaaaaaaaaaaaaaaaba
abaceeeeeeebeeeeeeeeeeeeeeeeebbbbbbbbbbbbbbbbbbbbbbbbbbbbbcaaaaaaaaaaaaaaaaaaaaaaaaaaaaaba
abaceehhheeeeeeeeeeeeeeeeeeeebeeeeeeeeeeeeeeeeeeeeeeeeeeeecaaaaaaaaaaaaaaaaaaaaaaaaaaaaaba
abaceeeiheeeeeeeeeeeeeeeeeeeebeeeeeeeeeeeeeeeeeeeeeeeeeeeecaaaaaaaaaaaaaaaaaaaaaaaaaaaaaba
abaceeeeheebeeeeeeeeeeeejjjjjbeeeeeeeeeeeeeeeeeeeeeeeeeeeecaaaaaaaaaaaaaaaaaaaaaaaaaaaaaba
abacbbbbbbbbbbbbeeeebbbbbbbbbbeeeeeeeeeeeeeeeeeeeeeeeeeeeecaaaaaaaaaaaaaaaaaaaaaaaaaaaaaba
abacjjjjeeeeeekeeeeeeeeeeeeeeeeeeeccccccccccccccccccceeeeccaaaaaaaaaaaaaaaaaaaaaaaaaaaaaba
abacjjeeeeeeeekeeeeeeeeeeeeeeeeeeecaaaaaaaaaaaaaaaaaaddddaaaaaaaaaaaaaaaaaaaaaaaaaaaaaaaba
abacjeeeeeeeeekeeeeeeeeeeeeeeeeeeecaaaaaaaaaaaaaaaaaadddddddddaaaaaaaaaaaaaaaaaaaaaaaaaaba
abacjeeeeeeeeekeeeeeeeeeeeeeeeeeeecaaaaaaaaaaaaaaaaaadddddddddaaaaaaaaaaaaaaaaaaaaaaaaaaba
abaceeeeeeeeeekeeeeebbeeeeeeeeeeeecaaaaaaaaaaaaaaaaaadddddddddaaaaaaaaaaaaaaaaaaaaaaaaaaba
abaceeeeeeeeekkeeeebbbeeeeeeeeeeeecaaaaaaaaaaaaaaaaaadddddddddaaaaaaaaaaaaaaaaaaaaaaaaaaba
abaceeeeeeeeeeeeeeeeebeeeeeeeeeeeecaaaaaaaaaaaaaaaaaaaaaaaddddaaaaaaaaaaaaaaaaaaaaaaaaaaba
abaceeeeeeeeeeeeeeeeebeeeeeeeeeeeecaaaaaaaaaaaaaaaaaaaaaaaddddaaaaaaaaaaaaaaaaaaaaaaaaaaba
abaceeeeeeeeeeeeeeeeebeeeeeeeeeeeecaaaaaaaaacccccccccccccaddddaaaaaaaaaaaaaaaaaaaaaaaaaaba
abaceeeeeeeeeeeeeeeeebeeeeeeeeeeeecaaaaaaaaacfeffeffeffecaddddaccccccccccccccaaaaaaaaaaaba
abaccccccccccccccccccccccceeeecccccaaaaaaaaacfeffeffeffecaddddaceeeeeeeeeeeecaaaaaaaaaaaba
abaaaaaaaaaaaaaaaaaaaaaaaaddddaaaaaaaaaaaaaacfeffeffeffecaddddaceeeeeeeeeeeecaaaaaaaaaaaba
abaaaaaaaaaaaaaaaaaaaaaaaaddddaaaaaaaaaaaaaacfeffeffeffecaddddaceeeeeeeeeeeecaaaaaaaaaaaba
abaaaaaaaaaaaaaaaaaaaaaaaaddddaaaaaaaaaaaaaaceeeeeeeeeeecceeeeccbkkkbeeeeeeecaaaaaaaaaaaba
abaaaaaaaaaaaaaaaaaaaaaaaaddddaaaaaaaaaaaaaaceeeeeeeeeeebeeeeeeeeeeebeeeeeeecaaaaaaaaaaaba
abaaaaaaaaaaaaaaaaaaaaaaaaddddaaaaaaaaaaaaaacbbbbbbbbeebbeeeeeeeeeeebeeeeeeecaaaaaaaaaaaba
abaaaaaaaaaaaaaaaaaaaaaaaaddddddddddddddddddeeeeeeeeeeeeeeeeeeeeeeeebeeeeeeecaaaaaaaaaaaba
abaaaaaaaaaaaaaaaaaaaaaaaaddddddddddddddddddeeeeeeeeeeeeeeeeeeeeeeeebeeeeeeecaaaaaaaaaaaba
abaaaaaaaaaaaaaaaaaaaaaaaaddddddddddddddddddeeeeeeeeeeeeeeeeeeeeeeeeeeeeeeeecaaaaaaaaaaaba
abaaaaaaaaaaaaaaaaaaaaaaaaddddddddddddddddddeeeeeeeeeeeeeeeeeeeeeeeeeeeeeeeecaaaaaaaaaaaba
abaaaaaaaaaaaaaaaaaaaaaaaaaaaaaaddddaaaaaaaacbbeebbbbbbbbbbbbbbbeeeebeeeeeeecaaaaaaaaaaaba
abaaaaaaaaaaaaaaaaaaaaaaaaaaaaaaddddaaaaaaaaceeeeeeeeeeeeeeeeeebeeeebbcccccccaaaaaaaaaaaba
abaaaaaaaaaaaaaaaaaaaaaaaaaaaaaaddddaaaaaaaaceeeeeeeeeeeeeeeeeebeeeeeecaaaaaaaaaaaaaaaaaba
abaaaaaaaaaaaaaaaaaaaaaaaaaaaaaaddddaaaaaaaaceeeeeeeeeeeeeeeeeeeeeeeeecaaaaaaaaaaaaaaaaaba
abaaaaaaaaaaaaaaaaaaaaaaaaaaaaaaddddaaaaaaaaceeeeeeeeeeeeeeeeeeeeeeeeecaaaaaaaaaaaaaaaaaba
abaaaaaaaaaaaaaaaaaaaaaaaaaaaaaaddddaaaaaaaaceeeeeeeeeeeeeeeeeebeeeeeecaaaaaaaaaaaaaaaaaba
abaaaaaaaaaaaaaaaaaaaaaaaaaaaaaaddddaaaaaaaaceeeeeeeeeeeeeeeeeebeeeeeecaaaaaaaaaaaaaaaaaba
abaaaaaaaaaaaaaaaaaaaaaaaaaaaaaaddddaaaaaaaaceeeeeeeeeeeeccccccceeeecccaaaaaaaaaaaaaaaaaba
abaaaaaaaagaaaaaaaaaaaaaaaaaaaaaddddaaaaaaaaceeeeeeeeeeeecaaaaaaddddaaaaaaaaaaaaaaaaaaaaba
abaaaaaaaaaaaaaaaaaaaaaaaaaaaaaaddddaaaaaaaaccccccccccccccaaaaaaddddaaaaaaaaaaaaaaaaaaaaba
abaaaaaaaaaaaaaaaaaaaaaaaaaaaaaaddddaaaaaaaaaaaaaaaaaaaaaaaaaaaaddddaaaaaaaaaaaaaaaaaaaaba
abaaaaaaaaaaaaaaaaaaaaaaaaaaaaaaddddaaaaaaaaaaaaaaaaaaaaaaaaaaaaddddaaaaaaaaaaaaaaaaccccca
abaaaaaaaaaaaaaaaaaaaaaaaaaaaaaaddddaaaaaaaaaaaaaaaaaaaaaaaaaaaaddddaaaaaaaaaaaaaaaaceeeca
abaaaaaaaaaaaaaaaaaaaaaaaaaaaaaaddddddddddddddaaaaaaaaaaaaaaaaaaddddaaaaaaaaaaaaaaddeeeeca
abaaaaaaaaaaaaaaaaaaaaaaaaaaaaaaddddddddddddddaaaaaaaaaaaaaaaaaaddddaaaaaaaaaaaaaadaceeeca
abaaaaaaaaaaaaaaaaaaaaaaaaaaaaaaddddddddddddddaaaaaaaaaaaaaaaaaaddddaaaaaaaaaaaaaadaccccca
abaaaaaaaaaaaaaaaaaaaaaaaaaaaaaaddddddddddddddaaaaaaaaaaaaaaaaaaddddaaaaaaaaaaaaaadaaaaaaa
abaaaaaaaaaaaaaaaaaaaaaaaaaaaaaadddddddddddddddddddddddddddddddddddddddddddddddddddddddddd
abaaaaaaaaaaaaaaaaaaaaaaaaaaaaaaaaaaaaaaaddddddddddddddddddddddddddddddddddddddddddddddddd
abaaaaaaaaaaaaaaaaaaaaaaaaaaaaaaaaaaaaaaaddddddddddddddddddddddddddddddddddddddddddddddddd
abaaaaaaaaaaaaaaaaaaaaaaaaaaaaaaaaaaaaaaaddddddddddddddddddddddddddddddddddddddddddddddddd
abaaaaaaaaaaaaaaaaaaaaaaaaaaaaaaaaaaaaaaadddddaaaaaaaaaaaaaaaaaaaaaaaaaaaaaaaaaaaaaaaaaaaa
abaccccccccccccccccccccccccccccccccccaaaadddddaaaaaaaaaaaaaaaaaaaaaaaaaaaaaaaaaaaaaabbbbba
abaceeeeeeeeeeeeeeeeeeeeeeeeeeeeeeeecaaaadddddaaaaaaaaaaaaaaaaaaaaaaaaaaaaaaaaaaaaaaaaaaba
abaceeeeeeeeeeeeeeeeeeeeeeeeeeeeeeeecaaaadddddaaaaaaaaaaaaaaaaaaaaaaaaaaaaaaaaaaaaaaaaaaba
abaceeeeeeeeeeeeeeeeeeeebbbeebbbbeebcaaaadddddaaaaaaaaaaaaaaaaaaaaaaaaaaaaaaaaaaaaaaaaaaba
abaceeeeeeeeeeeeeeeeeeeibeeeeebeeeeecaaaadddddaaaaaaaaaaaaaaaaaaaaaaaaaaaaaaaaaaaaaaaaaaba
abaceeeekkkeeekkkeeeekkkbeeeeebeeeeecaaaadddddaaaacccccccccccaaaaaaaaaaaaaaaaaaaaaaaaaaaba
abaceeeekjjeeekjjeeeejjkbhhheebhhheecaaaadddddaaaaceeeeeeeeecaaaaaaaaaaaaaaaaaaaaaaaaaaaba
abaceeeekjjeeekjjeeeejjkbeiheebeeheecaaaadddddaaaaceeeeeeeeecaaaaaaaaaaaaaaaaaaaaaaaaaaaba
abacjeeekjjeeekjjeeeejjkbeeeeebeeeeecaaaadddddddddeeebeeebeecaaaaaaaaaaaaaaaaaaaaaaaaaaaba
abacjeeeeeeeeeeeeeeeebbbbbbbbbbbbbbbcaaaadddddddddeeeeeeeeeecaaaaaaaaaaaaaaaaaaaaaaaaaaaba
abacjeeeeeeeeeeeeeeeeeeeeeeeeeeeeeeeedddddddddddddeeebeeebeecaaaaaaaaaaaaaaaaaaaaaaaaaaaba
abacjeeekkkeeekkkeeeeeeeeeeeeeeeeeeeedddddddddddddeeeeeeeeeecaaaaaaaaaaaaaaaaaaaaaaaaaaaba
abaceeeekjjieekjjeeeeeeeeeeeeeeeeeeeedddddddddaaaaceeeeeeeeecaaaaaaaaaaaaaaaaaaaaaaaaaaaba
abaceeeekjjeeekjjeeeeeeeeeeeeeieeeeeedddddddddaaaacccceeeecccaaaaaaaaaaaaaaaaaaaaaaaaaaaba
abaceeeekjjeeekjjeeeebeeeebbbbbeebcccaaaadddddaaaaaaaaddddaaaaaaaaaaaaaaaaaaaaaaaaaaaaaaba
abaceeeeeeeeeeeeeeeeebeeeebeeeeeeecaaaaaadddddaaaaaaaaddddaaaaaaaaaaaaaaaaaaaaaaaaaaaaaaba
abaceeeieeeeeeeeeeeeebeeeebeeeeeeecaaaaaadddddaaaaaaaaddddaaaaaaaaaaaaaaaaaaaaaaaaaaaaaaba
abacbeebbbbbbbbbbbbbbbeeeebeeeeeeecaaaaaadddddddddddddddddaaaaaaaaaaaaaaaaaaaaaaaaaaaaaaba
abaceeeeeeeeeeeeeeeeeeeeeebeeeeeeecaaaaaadddddddddddddddddaaaaaaaaaaaaaaaaaaaaaaaaaaaaaaba
abaceeeeeeeeeeeeeeeeeeeeeebeeeeeeecaaaaaadddddddddddddddddaaaaaaaaaaaaaaaaaaaaaaaaaaaaaaba
abaceieeeeeeeeeeeeeeeeeeeebeeeeeeecaaaaaadddddddddddddddddaaaaaaaaaaaaaaaaaaaaaaaaaaaaaaba
abaceeeeeeeeeeeeeeeeeeeeeebeeeeeeecaaaaaadddddddddddddddddaaaaaaaaaaaaaaaaaaaaaaaaaaaaaaba
abacbbbbbbeebbbbbbbeebeeebbbbbeebbcaaaaaaaaaaaaaaaaaaaaaaaaaaaaaaaaaaaaaaaaaaaaaaaaaaaaaba
abaceeeeeeeebeeeeeeeebeeeeeeeeeeeecaaaaaaaaaaaaaaaaaaaaaaaaaaaaaaaaaaaaaaaaaaaaaaaaaaaaaba
abaceeeeeeeebeeeeeeeebeeeeeeeeeeeecaaaaaaaaaaaaaaaaaaaaaaaaaaaaaaaaaaaaaaaaaaaaaaaaaaaaaba
abacbeebbbbbbbeebbbbbbkeeekkeeekkecaaaaaaaaaaaaaaaaaaaaaaaaaaaaaaaaaaaaaaaaaaaaaaaaaaaaaba
abacheeeeeeebheeeeeeebkeeekkieekkecaaaaaaaaaaaaaaaaaaaaaaaaaaaaaaaaaaaaaaaaaaaaaaaaaaaaaba
abacheebieeebheeebeeebkeeekkeeekkecaaaaaaaaaaaaaaaaaaaaaaaaaaaaaaaaaaaaaaaaaaaaaaaaaaaaaba
abacheebbbbbbheeebbbbbkieekkeeekkecaaaaaaaaaaaaaaaaaaaaaaaaaaaaaaaaaaaaaaaaaaaaaaaaaaaaaba
abacheebeeeebheeebeeebkeeekkeeekkecaaaaaaaaaaaaaaaaaaaaaaaaaaaaaaaaaaaaaaaaaaaaaaaaaaaaaba
abacheeeeeeebheeeeeeebeeeeeeeeeeeecaaaaaaaaaaaaaaaaaaaaaaaaaaaaaaaaaaaaaaaaaaaaaaaaaaaaaba
abaccccccccccccccccccceeeeeeeeeeeecaaaaaaaaaaaaaaaaaaaaaaaaaaaaaaaaaaaaaaaaaaaaaaaaaaaaaba
abaaaaaaaaaaaaaaaaaaaccccccccccccccaaaaaaaaaaaaaaaaaaaaaaaaaaaaaaaaaaaaaaaaaaaaaaaaaaaaaba
abbbbbbbbbbbbbbbbbbbbbbbbbbbbbbbbbbbbbbbbbbbbbbbbbbbbbbbbbbbbbbbbbbbbbbbbbbbbbbbbbbbbbbbba
aaaaaaaaaaaaaaaaaaaaaaaaaaaaaaaaaaaaaaaaaaaaaaaaaaaaaaaaaaaaaaaaaaaaaaaaaaaaaaaaaaaaaaaaaa
"}
