"aa" = (/obj/Autojoin/Clifftop/Cavewall,/turf/Basic/Obsidian,/area)
"ab" = (/obj/Autojoin/Clifftop/Cavewall,/turf/Basic/DarkDirt,/area)
"ac" = (/obj/Autojoin/Clifftop/Cavewall,/obj/Autojoin/Clifftop/Cavewall,/turf/Basic/Obsidian,/area)
"ad" = (/turf/Basic/Obsidian,/area)
"ae" = (/turf/Basic/DarkDirt,/area)
"af" = (/obj/Environment/Cave/TallRocks/Grey,/turf/Basic/Obsidian,/area)
"ag" = (/obj/Autojoin/LavaPool,/turf/Basic/Obsidian,/area)
"ah" = (/turf/Basic/Lava,/area)
"ai" = (/obj/Autojoin/Clifftop/Cavewall,/obj/Autojoin/Obsidian,/turf/Basic/DarkDirt,/area)
"aj" = (/obj/Environment/Cave/Spikes/Obsidian,/turf/Basic/Obsidian,/area)
"ak" = (/obj/Autojoin/Obsidian,/turf/Basic/DarkDirt,/area)
"al" = (/obj/Autojoin/Dirt,/turf/Basic/DarkDirt,/area)
"am" = (/turf/Basic/Dirt,/area)
"an" = (/obj/Autojoin/Clifftop/Cavewall,/turf/Basic/DarkDirt,/area/NoScroll)
"ao" = (/obj/Autojoin/Clifftop/Cavewall,/obj/Autojoin/LavaPool,/turf/Basic/Obsidian,/area)
"ap" = (/obj/Autojoin/Clifftop/Cavewall,/turf/Basic/Obsidian,/area/NoScroll)
"aq" = (/obj/Autojoin/LavaPool,/turf/Basic/DarkDirt,/area)
"ar" = (/obj/Autojoin/Clifftop/Cavewall,/obj/Autojoin/LavaPool,/turf/Basic/DarkDirt,/area)
"as" = (/obj/Autojoin/Clifftop/Cavewall,/turf/Basic/Dirt,/area)
"at" = (/obj/Autojoin/Clifftop/Cavewall,/turf/Basic/Lava,/area)
"au" = (/turf/Basic/Clifftop/High,/area)
"av" = (/obj/Environment/Cave/TallRocks/Med,/turf/Basic/Clifftop/High,/area)
"aw" = (/obj/Environment/Cave/Spikes/Dirt,/turf/Basic/Clifftop/High,/area)
"ax" = (/obj/Autojoin/Clifftop/Cavewall,/obj/Environment/Cave/LargeRocks/Alt{step_x = 28},/turf/Basic/DarkDirt,/area)
"ay" = (/obj/Environment/Cave/SmallRocks/Dark/Single,/turf/Basic/DarkDirt,/area)
"az" = (/obj/Autojoin/Clifftop/High,/turf/Basic/Obsidian,/area)
"aA" = (/obj/Environment/Cave/SmallRocks/Med/Single,/turf/Basic/DarkDirt,/area)
"aB" = (/obj/Autojoin/Dirt,/obj/Autojoin/Clifftop/Cavewall,/turf/Basic/DarkDirt,/area)
"aC" = (/obj/Autojoin/Clifftop/Med,/turf/Basic/Obsidian,/area)
"aD" = (/obj/Autojoin/Clifftop/High,/obj/Autojoin/Clifftop/Med,/turf/Basic/Obsidian,/area)
"aE" = (/obj/Autojoin/Clifftop/Med,/obj/Autojoin/Clifftop/High,/turf/Basic/Clifftop/High,/area)
"aF" = (/obj/Autojoin/Clifftop/Cavewall,/obj/Environment/Cave/SmallRocks/Med/Single{step_x = 24},/turf/Basic/DarkDirt,/area)
"aG" = (/obj/Environment/Cave/Spikes/DarkDirt,/turf/Basic/DarkDirt,/area)
"aH" = (/obj/Autojoin/Clifftop/Med,/obj/Autojoin/Clifftop/High,/turf/Basic/Obsidian,/area)
"aI" = (/obj/Environment/Cave/LargeRocks/Alt,/turf/Basic/DarkDirt,/area)
"aJ" = (/obj/Autojoin/Clifftop/Cavewall,/turf/Basic/Clifftop/High,/area)
"aK" = (/obj/Environment/Cave/TallRocks/Med{step_x = 4},/turf/Basic/DarkDirt,/area)
"aL" = (/obj/Environment/Cave/SmallRocks/Dark/Single{step_x = 3; step_y = 1},/turf/Basic/DarkDirt,/area)
"aM" = (/obj/Environment/Cave/TallRocks/Med{step_x = 22},/turf/Basic/Clifftop/High,/area)
"aN" = (/obj/Autojoin/Clifftop/Cavewall,/obj/Autojoin/Clifftop/Cavewall,/turf/Basic/DarkDirt,/area)
"aO" = (/obj/Autojoin/Clifftop/Cavewall,/obj/Autojoin/Dirt,/turf/Basic/DarkDirt,/area)
"aP" = (/obj/Autojoin/Dirt,/obj/Environment/Cave/SmallRocks/Med/SingleAlt,/turf/Basic/DarkDirt,/area)
"aQ" = (/obj/Autojoin/Dirt,/obj/Environment/Cave/LargeRocks/Alt,/turf/Basic/DarkDirt,/area)
"aR" = (/obj/Autojoin/Clifftop/Cavewall,/turf/Basic/Clifftop/Med,/area)
"aS" = (/turf/Basic/Clifftop/Med,/area)
"aT" = (/obj/Environment/Cave/SmallRocks/Med/SingleAlt,/turf/Basic/Clifftop/Med,/area)
"aU" = (/obj/Environment/Cave/LargeRocks/Single,/turf/Basic/Clifftop/Med,/area)
"aV" = (/obj/Environment/Cave/Spikes/Dirt,/turf/Basic/Clifftop/Med,/area)
"aW" = (/obj/Autojoin/Clifftop/Med,/obj/Autojoin/Clifftop/Cavewall,/turf/Basic/Obsidian,/area)
"aX" = (/obj/Autojoin/Clifftop/Cavewall,/obj/Autojoin/Clifftop/Med,/turf/Basic/Obsidian,/area)
"aY" = (/obj/Autojoin/Dirt,/obj/Environment/Cave/TallRocks/Med,/turf/Basic/DarkDirt,/area)
"aZ" = (/obj/Autojoin/Clifftop/Med,/obj/Autojoin/Clifftop/Cavewall,/obj/Autojoin/Clifftop/Med,/turf/Basic/Obsidian,/area)
"ba" = (/obj/Autojoin/Clifftop/Med,/obj/Environment/Cave/SmallRocks/Med/Single,/turf/Basic/Obsidian,/area)
"bb" = (/obj/Autojoin/Clifftop/Med,/obj/Environment/Cave/SmallRocks/Med/SingleAlt,/turf/Basic/Obsidian,/area)
"bc" = (/obj/Environment/Cave/SmallRocks/Dark/Stones,/turf/Basic/DarkDirt,/area)
"bd" = (/obj/Environment/Cave/SmallRocks/Med/Single,/turf/Basic/Clifftop/Med,/area)
"be" = (/obj/Autojoin/Dirt,/obj/MapMarker/Entrance{tag = "Entrance"},/turf/Basic/DarkDirt,/area)
"bf" = (/obj/Environment/Cave/TallRocks/Med,/turf/Basic/Dirt,/area)
"bg" = (/turf/Basic/Dirt,/area/Event)
"bh" = (/obj/MapMarker/Event/Exit{EntranceTag = "FromCaveTest"; MapName = "dynamic/objecttest"},/turf/Basic/Dirt,/area/Event)
"bi" = (/obj/Autojoin/Clifftop/Cavewall,/turf/Basic/Dirt,/area/Event)

(1,1,1) = {"
aaaaaaaaaaaaaaaaaaaaaaaaaaaaaaaaaaaaaaaaaaaaaaaaaaaaaaaaaaaaaaaaabababababababababababababababababababababababababababababababababababababababababababababababab
acacaaaaaaaaaaaaaaaaaaaaaaaaaaaaaaaaaaaaaaaaaaaaaaaaaaaaaaaaaaaaabababababababababababababababababababababababababababababababababababababababababababababababab
aaaaaaaaaaaaadadadadadadadadadadadadadadadadadadadaaaaaaaaaaaaaaabababababababababababababababababaeaeaeaeaeaeaeaeaeaeaeabababababababababababababababababababab
aaaaadadadadadadadadadadadadadadadadadadadadadadadadadaaaaaaaaaaabababababababababababaeaeaeaeaeaeaeaeaeaeaeaeaeaeaeaeaeaeaeaeaeaeababababababababababababababab
aaaaadadadadadadadadadadadadafadadadafadadadadadadadadadaaaaaaaaabababababaeaeaeaeaeaeaeaeaeaeaeaeaeaeaeaeaeaeaeaeaeaeaeaeaeaeaeaeaeaeaeaeababababababababababab
aaaaadadadadadadadafadadagagagagagagagagagagagadadadadadaaaaaaaaababaeaeaeaeaeaeaeaeaeaeaeaeaeaeaeaeaeaeaeaeaeaeaeaeaeaeaeaeaeaeaeaeaeaeaeaeaeababababababababab
aaaaadadadadadadagagagagagahahahahahahahahahagagafadadadaaaaaaaaabaeaeaeaeaeaeaeaeaeaeaeaeaeaeaeaeaeaeaeaeaeaeaeaeaeaeaeaeaeaeaeaeaeaeaeaeaeaeaeabababababababab
aaaaadadadadadadagahahahahahahahahahahahahahahagagadadadaaaaaaaiabaeaeaeaeaeaeaeaeaeaeaeaeaeaeaeaeaeaeaeaeaeaeaeaeaeaeaeaeaeaeaeaeaeaeaeaeaeaeaeaeababababababab
aaaaadadafadadagagahahahahahahahahahahahahahahahagadadajadaaaaaiaeaeaeaeaeaeaeaeaeaeaeaeaeaeaeaeaeaeaeaeaeaeaeaeaeaeaeaeaeaeaeaeaeaeaeaeaeaeaeaeaeaeabababababab
aaaaadadadadadagahahahahahahahahahahahahahahahahagadadadadadadakaeaeaeaeaeaeaeaeaeaeaeaeaeaeaeaeaeaeaeaeaeaeaeaeaeaeaeaeaeaeaeaeaeaeaeaeaeaeaeaeaeaeabababababab
aaaaadadadadadagahahahahahahahahahahahahahahahahagadadadadadadakaeaeaeaeaeaeaeaeaeaeaeaeaeaeaeaeaeaeaeaeaeaeaeaeaeaeaeaeaeaeaeaeaeaeaeaeaeaeaeaeaeaeaeababababab
aaaaadadadafadagahahahahahahahahahahahahahahahahagadadadadadadakaeaeaeaeaeaeaeaeaeaeaeaeaeaeaeaeaeaeaeaeaeaeaeaeaeaeaeaeaeaeaeaeaeaeaeaeaeaeaeaeaeaeaeababababab
aaaaadadadadadagahahahahahahahahahahahahahahahahagadadadadadadakaeaeaeaeaeaeaeaeaeaeaeaeaeaeaeaeaeabababaeaeaeaeaeaeaeaeaeaeaeaeaeaeaeaeaeaeaeaeaeaeaeaeabababab
aaaaadadadadafagahahahahahahahahahahahahahahahahagafadadadadadakaeaeaeaeaeaeaeaeaeaeaeaeaeaeaeaeababababababababaeaeaeaeaeaeaeaeaeaeaeaeaeaeaeaeaeaeaeaeabababab
aaaaadadadafadagahahahahahahahahahahahahahahahagagadadadadaaaaaiaeaeaeaeaeaeaeaeaeaeaeaeaeaeaeabababababababababababababaeaeaeaeaeaeaeaeaeaeaeaeaeaeaeaeabababab
aaaaadadafadagagahahahahahahahahahahahahagagagagadadadadaaaaaaaiabaeaeaeaeaeaeaeaeaeaeaeaeababababababababababababababababababaeaeaeaeaeaeaeaeaeaeaeaeaeabababab
aaaaadadadagagahahahahahahahahahahahahagagadafadadadadajaaaaaaaiababaeaeaeaeaeaeaeaeaeaeabababababababababababababababababababaeaeaeaeaeaeaeaeaeaeaeaeaeabababab
aaaaadadagagahahahahahahahahahahahagagagadadadadadadadadaaaaaaaaababaeaeaeaeaeaeaeaeaeaeabababababababababababababababababababaeaeaeaeaeaeaeaeaeaeaeaeaeabababab
aaaaadadagahahahahahahahahahahahagagafadadadadadadadadadaaaaaaaaabababaeaeaeaeaeaeaeaeaeaeaeaeababababababababababababababababaeaeaeaeaeaeaeaeaeaeaeaeaeabababab
aaaaafagagahahahahahahahahahahagagadadafadadadadadadadadaaaaaaaaababababaeaeaeaeaeaeaeaeaeaeaeaeabababababababababababababababaeaeaeaeaeaeaeaeaeaeaeaeaeabababab
aaaaadagahahahahahahahahahahahagadadadadadadadadadadadadaaaaaaaaababababaeaeaeaeaeaeaeaeaeaeaeaeababababababababababababababaeaeaeaeaeaeaeaeaeaeaeaeaeababababab
aaaaadagahahahahahahahahahahahagadadadadadadadadadadajadaaaaaaaaabababababaeaeaeaeaeaeaeaeaeaeaeabababababababababababaeaeaeaeaeaeaeaeaeaeaeaeaeaeaeabababababab
aaaaadagagahahahahahahahahahahagadadadadadadadadadadadadaaaaaaaaabababababaeaeaeaeaeaeaeaeaeaeaeaeababababababababaeaeaeaeaeaeaeaeaeaeaeaeaeaeaeaeababababababab
aaaaaaadagahahahahahahahahahagagafadadadadadadadadadadadaaaaaaaaabababababaeaeaeaealalalaeaeaeaeaeaeabababababaeaeaeaeaeaeaeaeaeaeaeaeaeaeaeaeababababababababab
aaaaaaafagahahahahahahagagagagadadadadadadadafadajadadadaaaaaaaaababababababaeaeaealamalalaeaeaeaeaeaeaeaeaeaeaeaeaeaeaeaeaeaeaeaeaeaeaeaeaeabababababababababab
aaaaaaadagagagagagagagagadadadadadadadadadadadadadadadaaaaaaaaaaababababababaeaeaealamamalaeaeaeaeaeaeaeaeaeaeaeaeaeaeaeaeaeaeaeaeaeaeaeaeababababababababababab
aaaaaaaaadadadadafadadadadadadadafadadadadadadadadadadaaaaaaaaababanababababaeaeaealamamalalaeaeaeaeaeaeaeaeaeaeaeaeaeaeaeaeaeaeaeaeaeaeabababababababababababab
aaaaaaaaadadadadadadadadadadadadadadadadadadadadadadaaaaaaaaabababanababababaeaeaealalamamalalaeaeaeaeaeaeaeaeaeaeaeaeaeaeaeaeaeaeaeaeababababababababababababab
aaaaaaaaadadafadadadadadadadadadadadadadadadadadajaaaaaaaaaaabababanababababaeaeaeaealalamamalalalaeaeaeaeaeaeaeaeaeaeaeaeaeaeaeaeaeabababababababababababababab
aaaaaaaaadadadadadadadafadadadadadadadadadadadadadaaaaaaaaababababanababababaeaeaeaeaealalamamamalalalaeaeaeaeaeaeaeaeaeaeaeaeaeababababababababababababaeaeabab
aaaaaaadadadadadadadadadadadadafadadadadadadadadaaaaaaaaabababababanabababababaeaeaeaeaealalamamamamalalalaeaeaeaeaeaeaeaeaeaeabababababababababababababaeaeabab
aaaaaaadadadadadadadadadadadadadadadadadadajadaaaaaaaaaaabababababanabababababaeaeaeaeaeaealalalamamamamalalalaeaeaeaeaeaeaeabababababababababababababaeaeaeabab
aaaaaaadadadadadadadagagadadadadadadadadajadadaaaaaaaaababababababanababababababaeaeaeaeaeaeaealalamamamamamalalaeaeaeaeaeaeababababababababababababaeaeaeaeabab
aaaaaaadadadadadadagagagadadadadadadadadadadaaaaaaaaaaababababababanababababababaeaeaeaeaeaeaeaealalalamamamamalaeaeaeaeaeababababababababababababaeaeaeaeaeabab
aaaaadadadadadadadagagagadadadadadadadadadadaaaaaaaaaaababababababanabababababababaeaeaeaeaeaeaeaeaealalalamamalaeaeaeaeaeabababababababababababaeaeaeaeaeaeabab
aaaaadadadadafadadadadadadadadadajadadadadaaaaaaaaaaaaababababababanababababababababaeaeaeaeaeaeaeaeaeaealalalalaeaeaeaeaeaeabababababababababaeaeaeaeaeaeaeabab
aaaaadadadadadadadadadadadadadadadadadadaaaaaaaaaaaaaaababababababanababababababababababaeaeaeaeaeaeaeaeaeaeaeaeaeaeaeaeaeaeaeabababababaeaeaeaeaeaeaeaeaeaeabab
aaaaadadadadadadadadajadadadadadadadadaaaaaaaaaaaaaaaaababababababanababababababababababaeaeaeaeaeaeaeaeaeaeaeaeaeaeaeaeaeaeaeaeaeaeaeaeaeaeaeaeaeaeaeaeaeaeabab
aaaaaaadadadadadadadadadadadajadadadaaaaaaaaaaaaaaaaaaababababababanababababababababababaeaeaeaeaeaeaeaeaeaeaeaeaeaeaeaeaeaeaeaeaeaeaeaeaeaeaeaeaeaeaeaeaeaeabab
aaaaaaadadajadadajadadadadadadadaaaaaaaaaaaaaaaaaaababababababababanababababababababababababaeaeaeaeaeaeaeaeaeaeaeaeaeaeaeaeaeaeaeaeaeaeaeaeaeaeaeaeaeaeaeaeabab
aaaaaaadadagagagagagagagagadadaaaaaaaaaaaaaaaaaaaaababababababababanabababababababababababababaeaeaeaeaeaeaeaeaeaeaeaeaeaeaeaeaeaeaeaeaeaeaeaeaeaeaeaeaeaeaeabab
aaaaadadadagagagagagagagagaaaaaaaaaaaaaaabaaaaaaabababababababababanababababababababababababababababaeaeaeaeaeaeaeaeaeaeaeaeaeaeaeaeaeaeaeaeaeaeaeaeaeaeaeaeabab
aaaaaaadadagagagaoaoaaaaaaaaaaaaaaaaaaaaaaaaaaababababababababababanababababababababababababababababababababaeaeaeaeaeaeaeaeaeaeaeaeaeaeaeaeaeaeaeaeaeaeaeaeabab
aaaaaaadadaaaaaaaaaaaaaaaaaaaaaaaaaaaaaaaaaaabababababababababababababababababababababababababababababababababababababaeaeaeaeaeaeaeaeaeaeaeaealalalalaeaeaeabab
aaaaaaaaaaaaaaaaaaaaaaaaaaaaaaaaaaaaaaaaaaababababababababababababababababababababababababababababababababababababababababababababaeaeaeaeaeaealamamalaeaeaeabab
aaaaaaaaaaaaaaaaaaaaaaaaaaaaaaaaaaaaaaaaababababababababababababababababababababababababababababababababababababababababababababababaeaeaeaeaealamamalaeaeaeabab
aaaaaaaaaaaaaaaaaaaaaaaaaaaaaaaaaaaaaaaaabababababababababababababababababababababababababababababababababababababababababababababababaeaeaeaealamamalaeaeaeabab
anapapapapapapapapapapapapapanananananananananananananananababababababababababababaeaeaeaeaeaeaeaeababababababababababababababababababaeaeaeaealamamalaeaeaeabab
ababababababababababababababababababababababababababababababababababababababababaeaeaeaeaeaeaeaeaeaeaeaeaeaeaeaeaeaeaeaeaeaeaeababababaeaeaeaealamamalaeaeaeabab
abababababababababababababababababababababababababababababababababababababababaeaeaeaeaeaeaeaeaeaeaeaeaeaeaeaeaeaeaeaeaeaeaeaeaeaeaeaeaeaeaeaealamamalaeaeaeabab
ababababababababababababababababababababababababababababababababababababaeaeaeaeaeaeaeaeaeaeaeaeaeaeaeaeaeaeaeaeaeaeaeaeaeaeaeaeaeaeaeaeaeaeaealamamalaeaeaeabab
abababababababababababababababababaeaeabababababababababababababababababaeaeaeaeaeaeaeaeaeaeaeaeaeaeaeaeaeaeaeaeaeaeaeaeaeaeaeaeaeaeaeaeaeaeaealamamalaeaeaeabab
ababababababababababababaeaeaeaeaeaeaeaeaeaeaeaeaeaeaeaeaeaeaeaeaeaeaeaeaeaeaeaeaeaeaeaeaeaealalalalalalalaeaeaeaeaeaeaeaeaeaeaeaeaeaeaeaeaealalamamalaeaeaeabab
abababababababababaeaeaeaeaeaeaeaeaeaeaeaeaeaeaeaeaeaeaeaeaeaeaeaeaeaeaeaeaeaeaeaeaeaeaealalalamamamamamalalalalalalalaeaeaeaeaeaeaeaeaeaealalamamalalaeaeaeabab
abababababababaeaeaeaeaeaeaeaeaeaeaeaeaeaeaeaeaeaeaeaeaeaeaeaeaeaeaeaeaeaeaeaeaeaeaeaeaealamamamamamamamamamamamamamalalalalalaeaeaeaeaeaealamamalalaeaeaeaeabab
ababababaeaeaeaeaeaeaeaeaeaeaeaeaeaealalalalalalalalalalalalalalaeaeaeaeaeaeaeaeaeaeaeaealalalalalalalalamamamamamamamamamamalalalaeaeaeaealalalalaeaeaeaeaeabab
ababaeaeaeaeaeaeaeaeaeaeaeaeaealalalalamamamamamamamamamamamamalaeaeaeaeaeaeaeaeaeaeaeaeaeaeaeaeaeaeaealalalalalalamamamamamamamalalaeaeaeaeaeaeaeaeaeaeaeaeabab
ababaeaeaeaeaeaeaeaeaeaeaeaealalamamamamamamamamamamamamamalalalaeaeaeaeaeaeaeaeaeaeaeaeaeaeaeaeaeaeaeaeaeaeaeaealalalalalalamamamalaeaeaeaeaeaeaeaeaeaeaeaeabab
ababaeaeaeaeaeaeaeaeaealalalalamamamamalalalalalalalalalalalaeaeaeaeaeaeaeaeaeaeaeaeaeaeaeaeaeaeaeaeaeaeaeaeaeaeaeaeaeaeaealalalamalaeaeaeaeaeaeaeaeaeaeaeaeabab
ababaeaeaeaeaeaeaeaealalamamamamamamalalaeaeaeaeaeaeaeaeaeaeaeaeaeaeaeaeaeaeaeaeaeaeaeaeaeaeaeaeaeaeaeaeaeaeaeaeaeaeaeaeaeaeaealalalaeaeaeaeaeaeaeaeaeaeaeaeabab
ababaeaeaeaeaeaeaealalamamamamamamalalaeaeaeaeaeaeaeaeaeaeaeaeaeaeaeaeaeaeaeaeaeaeaeaeaeaeaeaeaeaeaeaeaeaeaeaeaeaeaeaeaeaeaeaeaeaeaeaeaeaeaeaeaeaeaeaeaeaeaeabab
ababaeaeaeaeaeaeaealamamamamalalalalaeaeaeaeaeaeaeaeaeaeaeaeaeaeaeaeaeaeaeaeaeaeaeaeaeaeabababababababababaeaeaeaeaeaeaeaeaeaeaeaeaeaeaeaeaeaeaeaeaeaeaeaeaeabab
ababaeaeaeaeaeaeaealamamamalalaeaeaeaeaeaeaeaeaeaeaeaeaeaeaeaeaeaeaeaeaeaeaeaeaeabababababababababababababababababaeaeaeaeaeaeaeaeaeaeaeaeaeaeaeaeaeaeaeaeaeabab
ababaeaeaeaeaeaeaealamamamalaeaeaeaeaeaeaeaeaeaeaeaeaeaeaeaeaeaeaeaeaeaeaeaeaeababababababababababababababababababababaeaeaeaeaeaeaeaeaeaeaeaeaeaeaeaeaeaeaeabab
ababaeaeaeaeaeaeaealamamamalaeaeaeaeaeaeaeaeaeaeaeaeaeaeaeaeaeaeaeaeaeaeaeabababababababababababababababababababababababaeaeaeaeaeaeaeaeaeaeaeaeaeaeaeaeaeaeabab
ababaeaeaeaeaeaeaealamamamalaeaeaeaeaeaeaeaeaeaeaeaeaeaeaeaeaeaeaeaeaeaeabababababababababababababababababababababababababaeaeaeaeaeaeaeaeaeaeaeaeaeaeaeaeaeabab
ababaeaeaeaeaeaeaealamamamalaeaeaeaeaeaeabababababaeaeaqaqaqaqaqaqaqaqararababababababababababababababababababababababababaeaeaeaeaeaeaeaeaeaeaeaeaeaeaeaeaeabab
asasaeaeaeaeaeaeaealalamamalaeaeaeaeaeababababababababarahahahahahahatararabababababababababababababababababababababababababaeaeaeaeaeaeaeaeaeaeaeaeaeaeaeaeabab
asasaeaeaeaeaeaeaeaealalalalaeaeaeaeaeababababababababararatahahahahatarababababababababaeaeaeaeaeaeaeabababababababababababaeaeaeaeaeaeaealalalalaeaeaeaeaeabab
asasabaeaeaeaeaeaeaeaeaeaeaeaeaeaeaeaeabababababababababararaqaqaqaqararabaeaeaeaeaeaeaeaeaeaeaeaeaeaeaeababababababababababaeaeaeaeaeaeaealamamalaeaeaeaeaeabab
asasabaeaeaeaeaeaeaeaeaeaeaeaeaeaeaeaeabababababababababababaeaeaeaeaeaeaeaeaeaeaeaeaeaeaeaeaeaeaeaeaeaeaeabababababababababaeaeaeaeaeaealalamamalaeaeaeaeaeabab
asasabaeaeaeaeaeaeaeaeaeaeaeaeaeaeaeaeaeabababababababababaeaeaeaeaeaeaeaeaeaeaeaeaeaeaeaeaeaeaeaeaeaeaeaeabababababababababaeaeaeaeaealalamamamalaeaeaeaeaeabab
asasababaeaeaeaeaeaeaeaeaeaeaeaeaeaeaeaeaeababababababaeaeaeaeaeaeaeaeaeaeaeaeaeaeaeaeaeaeaeaeaeaeaeaeaeaeaeaeabababababababaeaeaeaeaealamamamalalaeaeaeaeaeabab
asasababaeaeaeaeaeaeaeaeaeaeaeaeaeaeaeaeaeababababaeaeaeaeaeaeaeaeaeaeaeaeaeaeaeaeaeaeaeababaeaeaeaeaeaeaeaeaeaeabababababaeaeaeaeaealalamamamalaeaeaeaeaeaeabab
asasabababaeaeaeaeaeaeaeaeaeaeaeaeaeaeaeaeaeaeaeaeaeaeaeaeaeaeaeaeaeaeaeaeaeaeaeaeaeaeababababaeaeaeaeaeaeaeaeaeaeaeaeaeaeaeaeaeaealalamamamalalaeaeaeaeaeaeabab
asasabababababaeaeaeaeaeaealalalalalalalalalalalalalalalalalalalalalalaeaeaeaeaeaeaeaeababababaeaeaeaeaeaeaeaeaeaeaeaeaeaeaeaeaeaealamamamamalaeaeaeaeaeaeababab
ababababababababaeaeaealalalauauauauauauauavauawauauauauauauauauauaualalaeaeaeaeaeaeaeabababaxaeaeayaeaeaeaeaeaeaeaeaealalalalalalalamamamalalaeaeaeaeaeaeababab
abababababababababaealalauauauazazazazazazazazazazazazazazazazazazauaualaeaeaeaeaeaeaeababababaeaAaeayaeaeaeaeaeaeaeaealamamamamamamamamalalaeaeaeaeaeaeabababab
abababababababababaBalauauazazazadadadadadadadaCaCaCaCaCaCaCaCaCaDaEaualalalalaeaeaeaeabababaFaeaGaAaeaeaGaeaeaeaeaeaealalalalalalamalalalaeaeaeaeaeaeababababab
ababababababababaBaBauauazazadadadadadadadadadaCaCaCaCaCaCaCaCaCaHaEauauauaualaeaeaeabababababaeaeaeaIaeaeaeabababaeaeaeaeaeaeaealalalaeaeaeaeaeaeaeaeababababab
ababababababababaBaJauazazadadadadadadadadadadaCaCaCaCaCaCaCaCaCaDaDazazazaualaeaeababababababaeaeaeaeaKaLababababababababaeaeaeaeaeaeaeaeaeaeaeaeaeabababababab
abababababababaealauazazadadadagagagagagadadadadadadadadadadadadazazazazazaualaeaeabababababaeaeaeaeaeaeaeabababababababababababaeaeaeaeaeaeaeaeaeababababababab
ababababababaeaealaMazadadagagagahahahagagadajadadadadadadadadadadadadadazaualaeaeabababababaeaeaeaeaeaeaeabababababababababababababaeaeaeaeaeaeabababababababab
abababababaeaeaealauazadadagagagahahahagagagagagagagagagagagadadadadadadazaualaeaeababababaeaeaeaeaeaeaeaeaeabababababababababababababababababababababababababab
ababababaeaeaeaealauazadadadajagagagahahahahahahahahahahagagadadadadadazazaualaeaeaeababaeaeaeaeaeaeaeaeaeaeaeababababababababababababababababababababababababab
ababababaeaeaeaealauazazadadadadadagagagahagagagahahahagagajadadadadadazauaualaeaeaeaeaeaeaeaeaeaeaeaeaeaeaeaeaeaeababababababababababababababababababababababab
ababababaeaeaeaealauauazazazazazadadadagagagadagagagagagadadadadadazazazaualalaealalalaeaeaeaeaeaealalalaeaeaeaeaeaeaeaeabababababababababababababababababababab
abababaeaeaeaeaealalauauauauauazazazazazazazazazazazadadadadazazazazauauaualaeaealamalalaeaeaeaealalamalaeaeaeaeaeaeaeaeabababababababababababababababababababab
ababaeaeaeaeaeaeaealalalalalauauauauauauauauauauauazazazazazazauauauaualalalaeaealamamalaeaealalalamamalaeaeaeaeaeaeaeababababababababaeaeaeaeaeaeababababababab
ababaeaeaeaeaeaeaeaeaeaeaealalalalalalalalalalalauauauauauauauaualalalalaeaeaeaealamamalalalalamamamalalaeaeaeaeaeaeaeababababababaeaeaeaeaeaeaeaeaeaeababababab
ababaeaeaeaeaeaeaeaeaeaeaeaeaeaeaeaeaeaeaeaeaealalalalalalalalalalaeaeaeaeaeaeaealamamamamamamamamalalaeaeaeaeaeaeabababababababaeaeaeaeayaeaeaeaeaeaeababababab
ababaeaeaeaeaeaeaeaeaeaeaeaeaeaeaeaeaeaeaeaeaeaeaeaeaeaeaeaeaeaeaeaeaeaeaeaeaealalamamamamamamalalalaeaeaeaeaeaeabababababababaeaeaeaeaeaeaeaeaeaeaeaeababababab
ababaeaeaeaeaeaeaeaeaeaeaeaeaeaeaeaeaeaeaeaeaeaeaeaeaeaeaeaeaeaeaeaeaeaealalalalamamamamamalalalaeaeaeaeaeaeaeabababababababaeaeaeaeaeaeaeaeaeaeaGaeaeaeabababab
ababaeaeaeaeaeaeaeababaNababaeaeaeaeaeaeaeaeaeaeaeaeaeaeaeaeaeaeaeaeaeaealamamamamalalalalalaeaeaeaeaeaeaeababababababababaeaeaeaGaeaeaeaeaeaeaeaeaeayaeaeababab
ababaeaeaeaeaeaeabababababababaeaeaeaeaeaeaeaeaeaeaeaeaeaeaeaeaeaeaeaeaealalalalalalaeaeaeaeaeaeaeaeaeaeababababababababaeaeaeaeaeaeaeaeaeaeaeaeaeaeaeababababab
ababaeaeaeaeaeaeabababababababaeaeaeaeaeaeaeaeaeaeaeaeaeaeaeaeaeaeaeaeaeaeaeaeaeaeaeaeaeaeaeaeaeaeaeaeaeababababababaeaeaeaeaeaeaeaeaeaeaeaeaeaeaeaeabababababab
ababaeaeaeaeaeaeaeaeaeababababaeaeaeaeaeaeaeaeaeaeaeaeaeaeaeaeaeabababaOalalalalalalaPalaQalalalalaPalaOaOaOabababaeaeayaeaeaeaeaeaeaeaeaeaeaeaeaeaeabababababab
ababaeaeaeaeaeaeaeaeaeaeaeaeaeaAaeaeaeaeaeaeaeaeaeaeaeaeabababababababaRaRaRaSaTaSaUaSaSaVaSaTaSaVaSaTaRaRabababaeaeaeaeaeaeaeaeaeaeaeaeaeaeaeaeaeaeabababababab
aNaNaeaeaeaeaeaeaeaeaeaeaeaeaeaeaeaealalalalaeaeaeaeaeababababababababaWaWaWaWaCaCaCaCaCaCaCaCaCaCaCaCaWaXabababaeaGaeaeaeaeaeaeaeaeaeaeaeaeaeaeaeaeaeaeabababab
aNaNaeaeaeaeaeaeaeaeaeaeaeaeaeaeaealalamamalaeaeaeababababababababababaWaaaaaaaaadadadadadadadadadadadaaaaabababaeaeaeaeaeaeaeaeaeaeaeaeaeaeaeaeaeaeaeaeabababab
aNaNaeaeaeaeaeaeaeaeaeaeaeaeaeaealalamamamalaeaGaeababababababababababaWaaaaaaaaadadadadadadadadadadadaaaRabaBabababaeaeaeaeaeaeaeaeaeaeaeaeaeayaeaeaeaeabababab
aNaNaeaeaeaeaeaeaeaeaeaeaeaeaeaealamamamalalaeaeaeaeabababababababababaWaaaaaaaaadadadadadadadadadadadaaaRabaBababababaeaeaeaeaeaeaeaeaeaeaeaeaeaeaeabababababab
aNaNaeaeaeaeaeaeababaeaeaeaeaealaYamamaPalaeaeaeaeaeabababababababababaWaWaWaWaZaZaCaCbaaCaCaCbbaCaCbaaWaWaRaBababababbcaeaeaeaeaeaeaeaeaeaeaeaeabababababababab
aNaNaeaeaeaeaeaeabababaeaeaeaealamamamalaeaeaeaeaeaeababababababababababababaRaRaRbdaSaSbdaTbdaSaSbdaSaRaRaRaBababababaeaeaeaeaeaeaeaeaeaeaeaeababababababababab
aNaNaeaeaeaeaeaeabababaeaeaGaealamamalalaeaeaeaeaGaeabababababababababababababaOaOalalalalalalalaQalalalaBaBaBabababababaeaeaeaeaeaeaeaeaeayaeababababababababab
aNaNaeaeaeaeaeaeabababaeaeaeaealamamalaeaeaeaeaeaeababababababababababababababababaeaIaeaeaeaeaeaeaeaeaeababababababababbcaeaeaeaeaeaeaeaeaeaeaeaeaeabababababab
aNaNaeaeaeaeaeababababaeaeaeaealamamalaeaeaeaeaeabababababababababababababababababaeaeaeaeaeaeaeaeaeaeaeaeabababababababaeayaeaeaeaeaeaeaeaeaeaeaeaeaeaeaeababab
aNaNaeaeaeaeaeababababaGaeaeaealamamalaeaeaeaeabababababababababababababababababaeaeaeaeaeaeaeaeaeaeaeaeaeabababaeaeaeaeaeaeaeaeaeaeaeaeaeaeaeaeaeaeaeaeaeababab
aNaNaeaeaeaeaeababababaeaeaeaealamamalalaeaeaeababababababababababababababababaeaeaeaeaeaeaeaeaeaeaeaeaeaeaeaeaeaeaeaeaeaeaeaeaeaeaeaeaeaeaeaeaeaeaeaeaeaeababab
aNaNaeaeaeaeaeababababaeaeaeaealamamamalaeaeaeaeababababababababababaeaeaeaeaeaeaeaeaeaeaeaeaeaeaeaeaeaeaeaeaeaeaeaeaeaeaeaeaeaeaeaeaeaeaeaeaeaeaeaGaeaeaeababab
aNaNaeaeaeaeaeabababababaeaeaeaPalamamalaeaeaeaeabababababababababaeaeaeaeaeaeaeaeaeaeaeaeaeaeaeaeaeaeaeaeaeaeaeaeaeaeaeaeaeaeaeaeaeaeaeaeaeaeaeaeaeaeaeabababab
aNaNaeaeaeaeaeabaNaNababaeaeaeaealamalalaeaeaeaeaeaeaeabababababaeaeaeaeaeaeaeaeaeaeaeaeaeaeaeaeaeaeaeaeaeaeaeaeaeaeaeaeaeaeaebcaeaeaeaeaeaeaeaeaeaeaeaeabababab
aNaNaeaeaeaeaeabababababaeaeaeaealalalaeaeaeaeaeaeaeaeaeaeaeaeaeaeaeaeaeaeaeaeaeaeaeaeaeaeaeaeaeaeaeaeaeaeaeaeaeaeaeaeababababbcaeaeaeaeaeaeaeaeaeaeaeababababab
aNaNaeaeaeaeaeaeabababaeaeaeaeaeaeaeaeaeaeaeaeaeaeaeaeaeaeaeaeaeaeaeaeaeaeaeaeaeaeaeaeaeaeaeaeaeaeaeaeaeaeaeaeababababababababaeaeaeaeaeaeaeaeaeaeaeaeababababab
aNaNaeaeaeaeaeaeaeaeaeaeaeaeaeaeaeaeaeaeaeaeaeaeaeaeaeaeaeaeaeaeaeaeaeaeaeaeaeaeaeaeaeaeaeaeaeaeaeaeaeaeaeababababababababababababaeaeaeaeaeaeaeaeaeabababababab
ababaeaeaeaeaeaeaeaeaeaeaeaeaeaeaeaeaeaealalbealalalaeaeaeaeaeaeaeaeaeaeaeaeaeaeaeaeaeaeaeaeaeaeaeaeaeaeabababababababababababababababaeaeaeaeaeaeababababababab
ababaeaeaeaeaeaeaeaeaeaeaeaeaeaeaeaealalalamamambfalalalaeaeaeaeaeaeaeaeaeaeaeaeaeaeaeaeaeaeaeaeaeaeaeababababababababababababababababababababababababababababab
ababaeaeaeaeaeaeaeaeaeaeaeaeaeaeaeaealamamamamamamamamalaeaeaeaeaeaeaeaeaeaeaeaeaeabababababababababaeababababababababababababababababababababababababababababab
ababababababababababababababababababaObgbgbgbhbgbgbgbgaOabababababababababababababababababababababababababababababababababababababababababababababababababababab
ababababababababababababababababababaObibgbgbgbgbgbgbiaOabababababababababababababababababababababababababababababababababababababababababababababababababababab
"}
