"aa" = (/turf/Basic/Grass,/area)
"ab" = (/turf/Decorative/Grass,/area)
"ac" = (/turf/Autojoin/BigDarkGrass,/area)
"ad" = (/turf/Decorative/DarkGrass,/area)
"ae" = (/turf/Autojoin/BigSand,/area)
"af" = (/obj/Foliage/PlantLife/Flowers/Crops/Cabbages,/turf/Basic/Grass,/area)
"ag" = (/obj/Foliage/PlantLife/Flowers/Crops/Carrots,/turf/Basic/Grass,/area)
"ah" = (/obj/Foliage/PlantLife/Flowers/Crops/Strawberries,/turf/Basic/Grass,/area)
"ai" = (/obj/Foliage/PlantLife/Flowers/Crops/Turnips,/turf/Basic/Grass,/area)
"aj" = (/obj/Foliage/PlantLife/Flowers/Weeds,/turf/Basic/Grass,/area)
"ak" = (/obj/Foliage/Tree/DeadTree,/turf/Basic/Grass,/area)
"al" = (/obj/Foliage/Tree/ThinTree1{step_y = 0},/turf/Basic/Grass,/area)
"am" = (/obj/Foliage/PlantLife/Flowers/Clover,/turf/Basic/Grass,/area)
"an" = (/obj/Foliage/PlantLife/Cacti/Globular,/turf/Basic/Grass,/area)
"ao" = (/obj/Foliage/PlantLife/Cacti/Paddle,/turf/Basic/Grass,/area)
"ap" = (/obj/Foliage/PlantLife/Cacti/Saguaro,/turf/Basic/Grass,/area)
"aq" = (/obj/Foliage/PlantLife/Flowers/White,/turf/Basic/Grass,/area)
"ar" = (/obj/MapMarker/Entrance{tag = "ObjectTest"},/turf/Basic/Grass,/area)
"as" = (/obj/Foliage/Tree/OakTree,/turf/Basic/Grass,/area)
"at" = (/obj/Environment/Rock,/turf/Basic/Grass,/area)
"au" = (/obj/Environment/Stump/Mossy,/turf/Basic/Grass,/area)
"av" = (/obj/Environment/Log,/turf/Basic/Grass,/area)
"aw" = (/obj/Foliage/PlantLife/Bush/LongGrass,/turf/Basic/Grass,/area)
"ax" = (/obj/Foliage/PlantLife/Bush/Leafy/Small,/turf/Basic/Grass,/area)
"ay" = (/obj/Foliage/Tree/PalmTree,/turf/Autojoin/BigSand,/area)
"az" = (/obj/Environment/CliffFace/OuterCorner/NorthWest,/turf/Basic/Grass,/area)
"aA" = (/obj/Environment/CliffFace/Side/North,/turf/Basic/Grass,/area)
"aB" = (/obj/Environment/CliffFace/OuterCorner/NorthEast,/turf/Basic/Grass,/area)
"aC" = (/obj/Environment/CliffFace/Side/West,/turf/Basic/Grass,/area)
"aD" = (/obj/Environment/CliffFace/Side/East,/turf/Basic/Grass,/area)
"aE" = (/obj/Environment/Rock/Small,/turf/Basic/Grass,/area)
"aF" = (/obj/Environment/Stump/Log,/turf/Basic/Grass,/area)
"aG" = (/obj/Environment/Log/Mossy,/turf/Basic/Grass,/area)
"aH" = (/obj/Foliage/PlantLife/Bush/FlowerBush,/turf/Basic/Grass,/area)
"aI" = (/obj/Foliage/PlantLife/Bush/Leafy,/turf/Basic/Grass,/area)
"aJ" = (/obj/Environment/CliffFace/OuterCorner/SouthWest,/turf/Basic/Grass,/area)
"aK" = (/obj/Environment/CliffFace/Side/South,/turf/Basic/Grass,/area)
"aL" = (/obj/Environment/CliffFace/OuterCorner/SouthEast,/turf/Basic/Grass,/area)
"aM" = (/obj/Environment/Sign/TestSign,/obj/MapMarker/Interactible{InteractText = "Object Testing Ahead"},/turf/Basic/Grass,/area)
"aN" = (/obj/Environment/CliffFace/InnerCorner/SouthEast,/turf/Basic/Grass,/area)
"aO" = (/obj/Environment/CliffFace/Ramp/South,/turf/Basic/Grass,/area)
"aP" = (/obj/Environment/CliffFace/InnerCorner/SouthWest,/turf/Basic/Grass,/area)
"aQ" = (/obj/Environment/Stump,/turf/Basic/Grass,/area)
"aR" = (/obj/Environment/Stump/Axe,/turf/Basic/Grass,/area)
"aS" = (/obj/Foliage/PlantLife/Bush/Bush,/turf/Basic/Grass,/area)
"aT" = (/obj/Foliage/PlantLife/Bush/Fern,/turf/Basic/Grass,/area)
"aU" = (/obj/Foliage/PlantLife/Bush/Fern/Flowering,/turf/Basic/Grass,/area)
"aV" = (/obj/Environment/CliffFace/Ramp/East,/turf/Basic/Grass,/area)
"aW" = (/obj/Environment/CliffFace/Ramp/West,/turf/Basic/Grass,/area)
"aX" = (/turf/Autojoin/BigWater,/area)
"aY" = (/obj/Foliage/Autojoin/LightBush,/turf/Basic/Grass,/area)
"aZ" = (/obj/Environment/CliffFace/InnerCorner/NorthEast,/turf/Basic/Grass,/area)
"ba" = (/obj/Environment/CliffFace/Ramp/North,/turf/Basic/Grass,/area)
"bb" = (/obj/Environment/CliffFace/InnerCorner/NorthWest,/turf/Basic/Grass,/area)
"bc" = (/obj/MapMarker/Zone/Spawn/Attackers,/turf/Basic/Grass,/area)
"bd" = (/obj/Foliage/Tree/PineTree,/turf/Autojoin/BigSand,/area)
"be" = (/obj/Foliage/Tree/ThinTree2,/turf/Basic/Grass,/area)
"bf" = (/obj/Foliage/Tree/PineTree,/turf/Basic/Grass,/area)
"bg" = (/obj/Foliage/Tree/ThinTree2,/turf/Autojoin/BigSand,/area)
"bh" = (/obj/Environment/CliffFace/Side/North,/obj/Foliage/Tree/OakTree,/turf/Basic/Grass,/area)
"bi" = (/obj/Foliage/Tree/OakTree,/turf/Decorative/Grass,/area)
"bj" = (/obj/Foliage/PlantLife/Bush/LongGrass,/turf/Decorative/Grass,/area)
"bk" = (/obj/Environment/CliffFace/Side/West,/obj/Foliage/Tree/OakTree,/turf/Basic/Grass,/area)
"bl" = (/obj/Environment/CliffFace/Side/West,/obj/Foliage/Tree/PineTree,/turf/Basic/Grass,/area)
"bm" = (/obj/Foliage/PlantLife/Bush/Fern{step_x = 12; step_y = 14},/turf/Basic/Grass,/area)
"bn" = (/obj/Foliage/Tree/PineTree{step_x = -24; step_y = 4},/turf/Basic/Grass,/area)
"bo" = (/obj/Foliage/PlantLife/Flowers/Clover,/turf/Autojoin/BigSand,/area)
"bp" = (/obj/Foliage/PlantLife/Flowers/Weeds,/turf/Autojoin/BigSand,/area)
"bq" = (/obj/Foliage/Tree/DeadTree,/turf/Autojoin/BigSand,/area)
"br" = (/obj/Foliage/PlantLife/Flowers/Crops/Turnips,/obj/MapMarker/Event/Dialogue{DialogueText = "Don't trample the crops!"},/turf/Basic/Grass,/area/Event)
"bs" = (/obj/Foliage/PlantLife/Flowers/Crops/Carrots,/obj/MapMarker/Event/Dialogue{DialogueText = "Don't trample the crops!"},/turf/Basic/Grass,/area/Event)
"bt" = (/obj/Foliage/PlantLife/Flowers/Crops/Cabbages,/obj/MapMarker/Event/Dialogue{DialogueText = "Don't trample the crops!"},/turf/Basic/Grass,/area/Event)
"bu" = (/obj/Foliage/PlantLife/Flowers/Crops/Turnips,/turf/Basic/Grass,/area/Event)
"bv" = (/obj/Foliage/PlantLife/Flowers/Crops/Carrots,/turf/Basic/Grass,/area/Event)
"bw" = (/obj/Foliage/PlantLife/Flowers/Crops/Cabbages,/turf/Basic/Grass,/area/Event)
"bx" = (/obj/Foliage/PlantLife/Bush/Fern,/turf/Decorative/Grass,/area)
"by" = (/obj/Foliage/Tree/PineTree,/turf/Decorative/Grass,/area)
"bz" = (/obj/Foliage/Tree/OakTree,/obj/Foliage/PlantLife/Bush/Fern,/turf/Decorative/Grass,/area)
"bA" = (/obj/Foliage/PlantLife/Flowers/Clover,/turf/Decorative/Grass,/area)
"bB" = (/obj/Environment/CliffFace/Side/South,/obj/Foliage/PlantLife/Bush/Leafy/Small{step_x = 3; step_y = 18},/turf/Basic/Grass,/area)

(1,1,1) = {"
aaaaaaaaaaaaaaaaaaaaaaaaaaaaaaaaaaaaaaaaaaaaaaaaaaaaaaaaaaaaaaaaaaaaaaaaaaaaaaaaaaaaaaaaaaaaaaaaaaaaaaaaaaaaaaaaaaaaaaaaaaaaaaaaaaaaaaaaaaaaaaaaaaaaaaaaaaaaaaaaaaaaaaaaaaaaaaaaaaaaaaaaaaaaaaaaaaaaaaaa
aaaaaaaaaaaaaaaaaaaaaaaaaaaaaaaaaaaaaaaaaaaaaaaaaaaaaaaaaaaaaaaaaaaaaaaaaaaaaaaaaaaaaaaaaaaaaaaaaaaaaaaaaaaaaaaaaaaaaaaaaaaaaaaaaaaaaaaaaaaaaaaaaaaaaaaaaaaaaaaaaaaaaaaaaaaaaaaaaaaaaaaaaaaaaaaaaaaaaaaa
aaaaaaaaaaaaaaaaaaaaaaaaaaaaaaaaaaaaaaaaaaaaaaaaaaaaaaaaaaaaaaaaaaaaaaaaaaaaaaaaaaaaaaaaaaaaaaaaaaaaaaaaaaaaaaaaaaaaaaaaaaaaaaaaaaaaaaaaaaababaaabaaaaabaaabaaaaaaaaaaaaaaaaaaaaaaaaaaaaaaaaaaaaaaaaaaaa
aaaaaaaaaaaaaaaaaaaaaaaaaaaaaaaaaaaaaaaaaaaaaaaaaaaaaaaaaaaaaaaaaaaaaaaaaaaaaaaaaaaaaaaaaaaaaaaaaaaaaaaaaaaaaaaaaaaaaaaaaaaaaaaaaaaaaaababaaaaaaaaaaaaaaaaaaabaaaaaaaaaaaaaaaaaaaaaaaaaaaaaaaaaaaaaaaaaa
aaaaaaaaaaaaaaaaaaaaaaaaaaaaaaaaaaaaaaaaaaaaaaaaaaaaaaaaaaaaaaaaaaaaaaaaaaaaaaaaaaaaaaaaaaaaaaaaaaaaaaaaaaaaaaaaaaaaaaaaaaaaaaaaaaaaabaaaaaaaaaaaaaaaaaaaaaaaaaaabaaaaaaaaaaaaaaaaaaaaaaaaaaaaaaaaaaaaaa
aaaaaaaaaaaaaaaaaaaaaaaaaaaaaaaaaaaaaaaaaaaaaaaaaaaaaaaaaaaaaaaaaaaaaaaaaaaaaaababaaaaaaaaaaaaaaaaaaaaaaaaaaaaaaaaaaaaaaaaaaaaaaaaaaabaaaaaaaaaaaaaaaaaaaaaaaaabaaababaaaaabaaaaabaaababababaaabaaaaaaaa
aaaaaaaaaaaaaaaaaaaaaaaaaaaaaaaaaaaaaaaaaaaaaaaaaaaaaaaaaaaaaaaaaaaaaaaaaaababaaaaaaababaaaaababababababaaaaaaaaaaaaaaaaaaaaaaaaaaaaabaaaaaaaaaaaaaaaaaaaaabaaaaaaaaaaabaaaaaaaaabaaaaaaaaaaabaaaaabaaaa
aaaaaaaaaaaaaaaaaaaaaaaaaaaaaaaaaaaaaaaaaaaaaaaaaaaaaaaaaaaaaaaaaaaaaaaaabaaaaaaaaaaaaabababaaabababababaaaaaaaaaaaaaaaaabababaaaaaaabaaaaaaaaaaaaaaaaabaaaaaaaaaaaaaaaaaaaaaaabaaaaaaaaaaaaaaabaaaaaaab
aaaaaaaaaaaaaaaaaaaaaaaaaaaaaaaaaaaaaaaaaaaaaaaaaaaaaaaaaaaaaaaaaaaaaaababaaaaaaabababaaaaabaaaaaaababaaaaaaaaaaaaaaaaaaaaaaaaabaaaaabaaaaaaaaaaaaaaabaaaaaaabababaaaaaaabaaaaabaaaaaaaaaaaaaaaaabaaaaaa
aaaaaaaaaaaaaaaaaaaaaaaaaaaaaaaaaaaaaaaaaaaaaaaaaaaaaaaaaaaaaaaaaaaaaaaaaaaaababaaabaaaaaaabaaaaabaaabaaaaaaaaaaaaaaaaaaaaaaaaabaaaaabababababaaaaabaaaaababaaaaaaabaaaaaaababaaaaaaaaaaaaaaaaaaabaaaaaa
aaaaaaaaaaaaaaaaaaaaaaaaaaaaaaaaaaaaaaaaaaaaaaaaaaaaaaaaaaaaaaaaaaaaaaabababaaaaababaaaaabaaababaaabaaaaaaaaaaaaababaaaaaaabaaabaaabababaaaaaaabaaabaaabaaaaaaaaaaabababaaaaabaaabaaaaaaaaaaaaaaaaabaaaa
aaaaaaaaaaaaaaaaaaaaaaaaaaaaaaaaaaaaaaaaaaaaaaaaaaaaaaaaaaaaaaaaaaaaaaabababaaaaababababaaabaaaaaaabaaaaaaaaabababaaaaaaabaaabaaabaaaaabaaabaaaaabababaaaaaaaaaaabaaaaabaaabaaaaaaaaabaaaaaaaaaaaaabaaaa
aaaaaaaaaaaaaaaaaaaaaaaaaaaaaaaaaaaaaaaaaaaaaaaaaaaaaaaaaaaaaaaaaaaaaaabaaababababaaaaababaaaaaaabaaaaaaababaaabaaaaabaaaaababaaabaaaaaaabaaaaaaababaaaaababaaabababaaaaaaababaaaaaaaaabaaaaaaaaaaaaaaaa
aaaaaaaaaaaaaaaaaaaaaaaaaaaaaaaaaaaaaaaaaaaaaaaaaaaaaaaaaaaaaaaaaaaaaaabaaaaaaaaabababaaaaaaaaababaaababaaaaabaaaaabababaaaaaaabaaaaaaaaaaababaaaaaaaaababaaabaaaaaaabababababaaaaaaaaaaaaaaaaaaaaabaaaa
aaaaaaaaaaaaaaaaaaaaaaaaaaaaaaaaaaaaaaaaaaaaaaaaaaaaaaaaaaaaaaaaaaaaaaababaaababababaaaaaaaaaaabaaaaaaaaababaaababaaaaaaaaaaaaabaaaaaaaaaaaaababababababaaaaabaaaaabababaaabababaaaaaaaaabaaaaaaabaaaaaa
aaaaaaaaaaaaaaaaaaaaaaaaaaaaaaaaaaaaaaaaaaaaaaaaaaaaaaaaaaaaaaaaaaaaaaaaaaaaaaaaaaaaabaaaaabaaaaabaaaaabaaaaaaaaabaaaaaaaaaaaaabaaaaaaaaaaaaaaabaaaaabaaaaaaabaaaaaaaaababaaabaaabaaaaaaaaabaaabaaaaaaaa
aaaaaaaaaaaaaaaaaaaaaaaaaaaaaaaaaaaaaaaaaaaaaaaaaaaaaaaaaaaaaaaaaaaaaaaaaaaaaaaaaaaaaaaaaaaaaaaaaaaaabaaaaaaaaaaabaaaaaaaaaaaaabababababaaabababababaaabaaaaabaaabaaaaabaaaaababaaaaaaaaaaaaabaaaaaaaaab
aaaaaaaaaaaaaaaaaaaaaaaaaaaaaaaaaaaaaaaaaaaaaaaaaaaaaaaaaaaaaaaaaaaaaaaaaaaaaaaaaaaaaaaaaaaaaaaaaaabaaaaaaaaaaaaabaaaaaaaaaaabaaabaaaaababaaaaabaaabaaaaaaababababaaabaaaaaaaaaaababaaaaaaabaaaaaaaaabaa
aaaaaaaaaaaaaaaaaaaaaaaaaaaaaaaaaaaaaaaaaaaaaaaaaaaaaaaaaaaaaaaaaaaaaaaaaaaaaaaaaaaaaaaaaaaaaaaaabaaaaaaaaaaaaaaabaaaaaaaaabaaabaaabaaababaaabaaaaabaaaaaaaaaaaaababababaaaaaaaaababababababaaababaaaaaa
aaaaaaaaaaaaaaaaaaaaaaaaaaaaaaaaaaaaaaaaaaaaaaaaaaaaaaaaaaaaaaaaaaacacacacacacacacacacacacaaaaababaaaaaaaaabababaaabaaaaaaababaaaaaaabaaabaaaaabababaaaaaaaaaaaaabaaabaaabaaabaaaaabaaaaaaaaaaaaaaaaaaaa
aaaaaaaaaaaaaaaaaaaaaaaaaaaaaaaaaaaaaaaaaaaaaaaaaaaaaaaaaaaaaaaaaaacadadadadadadadadadadacaaaaabababaaababaaaaaaaaaaaaababaaaaababababababababababaaabaaaaaaaaaaabaaaaaaaaaaaaaaababaaababaaaaaaaaaaaaaa
aaaaaaaaaaaaaaaaaaaaaaaaaaaaaaaaaaaaaaaaaaaaaaaaaaaaaaaaaaaaaaaaaaacadadadadadadadadadadacaaaaaaaaaaaaaaaaaaaaaaaaaaaaababaaabababaaaaaaaaaaababababababaaaaaaabaaaaabaaaaaaababaaabaaaaababaaaaaaaaaaaa
aaaaaaaaaaaaaaaaaaaaaaaaaaaaaaaaaaaaaaaaaaaaaaaaaaaaaaaaaaaaaaaaaaacadadadadadadadadadadacaaaaaaaaaaaaaaaaaaaaaaaaaaaaabaaabababaaababaaababababababaaababababaaabaaaaaaaaabaaaaaaaaaaabaaaaabaaaaaaaaaa
aaaaaaaaaaaaaaaaaaaaaaaaaaaaaaaaaaaaaaaaaaaaaaaaaaaaaaacacacacacacacadadadacacacacacacacacaaaaaaaaaaaaaaabababababaaaaaaabaaaaabaaaaaaaaaaaaaaabaaabaaaaaaaaabaaaaabaaaaaaaaaaaaababaaaaaaaaaaaaaaaaaaaa
aaaaaaaaaaaaaaaaaaaaaaaaaaaaaaaaaaaaaaaaaaaaaaaaaaaaaaacadadadadadadadacacacaaaaaaaaaaaaaaaaaaaaaaababababaaaaaaababaaabababababaaaaaaaaabababababababaaaaaaaaabababaaaaabaaaaababaaaaaaaaaaaaabaaaaaaaa
aaaaaaaaaaaaaaaaaaaaaaaaaaaaaaaaaaaaaaaaaaaaaaaaacacacacadadadadadadadacaaaaaaaaababababaaaaaaabababaaaaaaaaaaaaaaabaaaaababaaababababababaaabaaaaabaaaaaaaaaaaaaaaaababababaaabaaaaaaaaaaaaaaabaaaaaaaa
aaaaaaaaaaaaaaaaaaaaaaaaaaaaaaaaaaaaaaaaaaaaaaacacadadadacacacacacacacacaaaaababaaaaaaababababaaaaaaaaaaaaaaaaabaaaaababababaaaaabaaaaaaaaabababaaababaaaaaaaaaaababaaababababaaabaaaaaaaaaaaaabaaaaaaaa
aaaaaaaaaaaaaaaaaaaaaaaaaaaaaaaaaaaaaaacacacacacadadacacacaaaaaaaaaaaaabababaaaaaaaaaaaaabaaaaaaaaaaaaaaaaabababaaaaabababababababababababaaaaababaaaaabaaabaaaaaaaaaaaaabaaaaaaaaaaaaabaaaaaaaaaaaaaaaa
aaaaaaaaaaaaaaaaaaaaaaaaaaaaaaaaaaacacacadadadadadadacaaaaaaaaaaaaaaaaabaaaaaaaaaaaaaaaaaaaaaaaaaaaaaaabababaaaaaaaaababababababababababababababaaabaaaaabaaababaaabababaaababaaaaaaaaaaabaaaaabaaaaaaaa
aaaaaaaaaaaaaaaaaaaaaaaaaaaaaaaaaaacadadadadadadadadacaaaaaaaaaaaaaaaaaeaeaeaeaeaeaeaeaeaeaeaaaaabababaaabaaaaabababababababaaaaabaaabaaaaaaababaaaaaaaaaaaaaaaaaaaaabaaaaabaaabaaaaaaaaaaaaabaaaaaaaaaa
aaaaaaaaaaaaaaaaaaaaaaaaaaaaaaaaaaacadadadadadadadadacaaaaaeaeaeaeaeaeaeaeaeaeaeaeaeaeaeaeaeaaaaababaaabaaababababaaaaaaabaaabaaaaaaababaaabaaaaabaaaaabaaaaaaaaaaaaaaaaaaaaaaaaabaaaaaaababaaabaaaaaaaa
aaaaaaaaaaaaaaaaaaaaaaaaaaaaaaaaaaacadadadadadadadadacaaaaaeaeaeaeaeaeaeaeaeaeaeaeaeaeaeaeaeaaaaaaaaabababababaaaaaaaaaaaaababababababaaabaaaaabaaabaaaaaaaaaaaaaaaaabaaaaaaabaaaaaaababaaaaaaabaaaaaaaa
aaaaaaaaaaaaaaaaaaaaaaaaaaaaaaaaaaacadadadadadadadadacaaaaaeaeaeaeaeaeaeaeaeaeaeaeaeaeaeaeaeaaaaaaababababaaaaaaaaaaabaaababaaabababaaabaaabaaabaaaaaaaaaaaaaaaaaaaaabaaaaaaaaabaaaaaaaaaaaaaaabaaaaaaaa
aaaaaaaaaaaaaaaaaaaaaaaaaaaaaaaaaaacadadadadadadadadacaaaaaaaaaaaaaaaaaeaeaeaeaaaaaaaeaeaeaeaaaaabababaaaaaaabaaabaaaaaaabaaabaaaaaaaaabababababaaaaaaaaaaaaaaaaaaaaabaaaaaaaaaaaaaaaaaaaaaaaaabaaaaaaaa
aaaaaaaaaaaaaaaaaaaaaaaaaaaaaaaaaaacacacacacacacacacacaaaaaaaaaaaaaaaaaeaeaeaeaaaaaaaeaeaeaeaaaaababababaaabaaaaaaaaababaaaaabaaabaaabaaaaababababaaaaaaaaaaaaabaaabaaaaaaaaaaaaabaaaaaaaaaaababaaaaaaaa
aaaaaaaaaaaaaaaaaaaaaaaaaaaaaaaaaaaaaaaaaaaaaaaaaaaaaaaaaaaaaaaaaaaaaaaeaeaeaeaaaaaaaeaeaeaeaaaaaaaaaaaaaaaaaaaaabaaaaabaaabaaaaaaaaaaaaaaaaaaaaaaababaaaaaaabaaaaaaaaaaaaaaaaaaaaabaaabababaaaaaaaaaaaa
aaaaaaaaaaaaaaaaaaaaaaaaaaaaaaaaaaaaaaaaaaaaaaaaaaaaaaaaaaaaaaaaaaaaaaaaaaaaaaaaaaaaaaaaaaaaaaaaaaaaaaaaaaaaababababaaaaaaaaaaaaaaaaaaaaaaaaaaaaaaaaaaaaaaaaaaaaaaaaaaaaaaaaaaaaaaaaaaaaaaaaaaaaaaaaaaaa
aaaaaaaaaaaaaaaaaaaaaaaaaaaaaaaaaaaaaaabababababababababababababababaaaaaaaaaaaaaaaaaaaaaaaaaaaaaaaaaaaaababababaaaaaaaaaaaaaaaaaaaaaaaaaaaaaaaaaaaaaaaaaaaaaaaaaaaaaaaaaaaaaaaaaaaaaaaaaaaaaaaaaaaaaaaa
aaaaaaaaaaaaaaaaaaaaaaaaaaaaaaaaaaaaaaabababababababababababababababaaaaaaaaaaaaaaaaaaaaaaaaaaaaaaaaaaaaaaaaaaaaaaaaaaaaaaaaaaaaaaaaaaafafaaagagaaahahaaaiaiaaajajaaaaaaaaaaaaaaaaaaaaaaaaaaaaaaaaaaaaaa
aaaaaaaaaaaaaaaaaaaaaaaaaaaaaaaaaaaaaaabababababababababababababababaaaaaaaaaaaaakaaaaaaakaaakaaaaakakakaaaaaaaaaaalaaaaalaaalaaalalalafafaaagagaaahahaaaiaiaaajajaaaaaaaaaaaaaaaaaaaaaaaaaaaaaaaaaaaaaa
aaaaaaaaaaaaaaaaaaaaaaaaaaaaaaaaaaaaaaabababababababababababababababaaaaakaaaaakaaakaaaaaaakaaaaaaakakakaaaaalaaalaaalaaaaalaaaaalalalaaaaaaaaaaaaaaaaaaaaaaaaaaaaaaaaaaaaaaaaaaaaaaaaaaaaaaaaaaaaaaaaaa
aaaaaaaaaaaaaaaaaaaaaaaaaaaaaaaaaaaaaaabababababababababababababababaaaaaaaaaaaaakaaaaaaakaaakaaaaakakakaaaaaaaaaaalaaaaalaaalaaalalalamamaaananaaaoaoaaapapaaaqaqaaaaaaaaaaaaaaaaaaaaaaaaaaaaaaaaaaaaaa
aaaaaaaaaaaaaaaaaaaaaaaaaaaaaaaaaaaaaaabababababababababababababababaaaaaaaaaaaaaaaaaaaaaaaaaaaaaaaaaaaaaaaaaeaeaeaeaeaeaeaeaeaeaeaaaaamamaaananaaaoaoaaapapaaaqaqaaaaaaaaaaaaaaaaaaaaaaaaaaaaaaaaaaaaaa
aaaaaaaaaaaaaaaaaaaaaaaaaaaaaaaaaaaaaaabababababababababababababababaaaaaaaaaaaaarabababababababababababaaaaaeaeaeaeaeaeaeaeaeaeaeaaaaaaaaaaaaaaaaaaaaaaaaaaaaaaaaaaaaaaaaaaaaaaaaaaaaaaaaaaaaaaaaaaaaaa
aaaaaaaaaaaaaaaaaaaaaaaaaaaaaaaaaaaaaaabababababababababababababababaaaaasaaababababaaaaaaaaaaababaaaaababaaaeaeaeaeaeaeaeaeaeaeaeaaaaatataaauauaaavaaaaawawaaaxaxaaaaaaaaaaaaaaaaaaaaaaaaaaaaaaaaaaaaaa
aaaaaaaaaaaaaaaaaaaaaaaaaaaaaaaaaaaaaaabababababababababababababababaaaaaaababababaaaaaeaeaeaeaaaaaeaeaaabaaaeaeaeaeaeaeayaeayaeaeaaaaatataaauauaaavaaaaawawaaaxaxaaazaAaBaaaaaaaaaaaaaaaaaaaaaaaaaaaaaa
aaaaaaaaaaaaaaaaaaaaaaaaaaaaaaaaaaaaaaabababababababababababababababaaaaaaababaaaaaaaaaeaeaeaeaaaaaeaeababaaaeaeayaeaeaeaeayaeaeaeaaaaaaaaaaaaaaaaaaaaaaaaaaaaaaaaaaaCaaaDaaaaaaaaaaaaaaaaaaaaaaaaaaaaaa
aaaaaaaaaaaaaaaaaaaaaaaaaaaaaaaaaaaaaaabababababababababababababababaaaaasaaababaaaaaaaeaeaeaeaeaeaeaeabaaaaaeaeaeaeaeaeayaeayaeaeaaaaaEaEaaaFaFaaaGaaaaaHaHaaaIaIaaaJaKaLaaaaaaaaaaaaaaaaaaaaaaaaaaaaaa
aaaaaaaaaaaaaaaaaaaaaaaaaaaaaaaaaaaaaaabababababababababababababababaaasaaasaaabaaaaaaaeaeaeaeaeaeaeaeabaaaaaeaeaeaeaeaeaeaeaeaeaeaaaaaEaEaaaFaFaaaGaaaaaHaHaaaIaIaaaaaaaaaaaaaaaaaaaaaaaaaaaaaaaaaaaaaa
aaaaaaaaaaaaaaaaaaaaaaaaaaaaaaaaaaaaaaaaaaaaaaaaaaaaaaaaaaaaaaaaaaaaaaaaasaaaaabaaaaaaaaaaaaaaaaaaaMaaaaabaaaeaeaeaeaeaeaeaeaeaeaeaaaaaaaaaaaaaaaaaaaaaaaaaaaaaaaaaaaNaOaPaaaaaaaaaaaaaaaaaaaaaaaaaaaaaa
aaaaaaaaaaaaaaaaaaaaaaaaaaaaaaaaaaaaaaaaaaaaaaaaaaaaaaaaaaaaaaaaaaaaaaabababababaaaaaaaaababaaaaaaaaaaaaaaabaeaeaeaeaeaeaeaeaeaeaeaaaaaQaQaaaRaRaaaSaSaaaTaTaaaUaUaaaVaaaWaaaaaaaaaaaaaaaaaaaaaaaaaaaaaa
aaaaaaaaaaaaaaaaaaaaaaaaaaaaaaaaaaaaaaaaaXaXaXaXaXaXaXaaaaaaaYaYaYaaaaaaaaaaaaaaaaaeaeaaababaaababababaaabaaaeaeayaeaeaeayayayaeaeaaaaaQaQaaaRaRaaaSaSaaaTaTaaaUaUaaaZbabbaaaaaaaaaaaaaaaaaaaaaaaaaaaaaa
aaaaaaaaaaaaaaaaaaaaaaaaaaaaaaaaaaaaaaaXaXaXaXaXaXaXaXaXaaaaaYaYaYaYaaasasasaaaaaeaeaeaaababababaaaaababaaaaaeayaeayaeaeayayayaeaeaaaaaaaaaaaaaaaaaaaaaaaaaaaaaaaaaaaaaaaaaaaaaaaaaaaaaaaaaaaaaaaaaaaaaa
aaaaaaaaaaaaaaaaaaaaaaaaaaaaaaaaaaaaaaaXaXaXaXaXaXaXaXaXaXaaaYaYaYaYaaasasasaaaaaeaeaebcaaababababababaaaaaaaeaeayaeaeaeayayayaeaeaaaaaaaaaaaaaaaaaaaaaaaaaaaaaaaaaaaaaaaaaaaaaaaaaaaaaaaaaaaaaaaaaaaaaa
aaaaaaaaaaaaaaaaaaaaaaaaaaaaaaaaaaaaaaaXaXaXaXaXaXaXaXaXaXaaaYaYaYaYaaasasasaaaaaeaeaeaaaaaaaaaaaaaaabaaaaaaaeaeaeaeaeaeaeaeaeaeaeaaaaaaaaaaaaaaaaaaaaaaaaaaaaaaaaaaaaaaaaaaaaaaaaaaaaaaaaaaaaaaaaaaaaaa
aaaaaaaaaaaaaaaaaaaaaaaaaaaaaaaaaaaaaXaXaXaXaXaXaXaXaXaXaXaaaYaYaYaYaaaaaaaaaaaaaeaeaaaeaeaaaeaeaaaaaaaaaaaaaeaeaeaeaaaaaaaaaaaaaaaaaaaaaaaaaaaaaaaaaaaaaaaaaaaaaaaaaaaaaaaaaaaaaaaaaaaaaaaaaaaaaaaaaaaa
aaaaaaaaaaaaaaaaaaaaaaaaaaaaaaaaaaaaaXaXaXaXaXaXaXaXaXaXaXaaaYaYaaaaaaaaaaaaaaaaaeaeaeaeaeaeaeaeaaaaaaaaaaaeaeaeaeaeaeaaaaaaaaaaaaaaaaaaaaaaaaaaaaaaaaaaaaaaaaaaaaaaaaaaaaaaaaaaaaaaaaaaaaaaaaaaaaaaaaaa
aaaaaaaaaaaaaaaaaaaaaaaaaaaaaaaaaaaXaXaXaXaXaXaXaXaXaXaXaXaaaYaYaaaaaaasaaasaaaaaeaeaeaeaebdaeaeaebdbdbdaaaebdaebdaeaeaeaaaabeaaaabeaabeaabebebeaaaaaaaaaaaaaaaaaaaaaaaaaaaaaaaaaaaaaaaaaaaaaaaaaaaaaaaa
aaaaaaaaaaaaaaaaaaaaaaaaaaaaaaaaaaaXaXaXaXaXaXaXaXaXaXaXaaaaaYaYaaaaaaaaasaaaaaaaabfaaaabdaebdaeaebdbdbdaeaeaebdaeaeaebgaabeaabeaaaabeaaaabebebeaaaaaaaaaaaaaaaaaaaaaaaaaaaaaaaaaaaaaaaaaaaaaaaaaaaaaaaa
aaaaaaaaaaaaaaaaaaaaaaaaaaaaaaaaaaaXaXaXaXaXaXaXaXaXaXaXaaaaaaaaaaabaaasaaasaaaaaaaaaaaeaebdaeaeaebfbdbdaeaebdaebdaeaeaeaaaabeaaaabeaabeaabebebeaaaaaaaaaaaaaaaaaaaaaaaaaaaaaaaaaaaaaaaaaaaaaaaaaaaaaaaa
aaaaaaaaaaaaaaaaaaaaaaaaaaaaaaaaaXaXaXaXaXaXaXaXaXaXaXaXaaaaaaaaaaabaaaaaaaaabaaaaaeaeaeaeaeaaaeaeaaaaaeaeaeaeaeaaaaaeaeaaaaazaAaAaAaAaAaAaAaAaAaAaAaAaAaAaAaAaAaAaAaAaAaAaAaAaAaAaAaAaAaAaAaAaAaAaAaAaA
aaaaaaaaaaaaaaaaaaaaaaaaaaaaaaaXaXaXaXaXaXaXaXaXaXaXaXaXaaaaaaaaababaaaaaaababaaaeaeaeaeaeaaaaaaaaaaaaaeaeaaaaaaaaaaaaaaaaaSaCazaAbhaAaAaAaAaAaAaAaAaAbhaAaAaAaAaAbhaAaAaAaAaAaAaAaAbhaAaAaAaAaAaAbhaAaA
aXaXaXaaaaaaaaaaaaaaaaaaaaaaaXaXaXaXaXaXaXaXaXaXaXaXaXaaaaaaaaaaabababaaababaaaaaeaeaeaaaaaaaEaaaaaaaaaaaaaaaaaaaaaaaaaeaeaaaCaCaaaaaaaabiababbiababbiababababaaaaaaaaaaaaaaasabababababbiabababaaaaaaaa
aXaXaXaXaXaXaaaaaaaaaXaXaXaXaXaXaXaXaXaXaXaXaXaXaXaXaXaaaaaaaaaaababaaababababaaaeaeaaaaaaaaaaaaaaaaaaaaaaawaaaaaaaaaaaeaeaaaCaCaaaaabababaaaaabababaaabababbiababbiababbiababaaaaabbjabababbiababababaa
aXaXaXaXaXaXaXaXaXaXaXaXaXaXaXaXaXaXaXaXaXaXaXaXaXaXaaaaaaaaaaababbiababababaaaeaeaeaaaaaaaaabaaaaaaaaaaazaAaAaAaAaBaSaaaaaaaCbkaabiababasbjabaaasabbiabaabjabababaaababaaaabjababbiababbjababaaababawaa
aXaXaXaXaXaXaXaXaXaXaXaXaXaXaXaXaXaXaXaXaXaXaXaXaXaXaaaaaaaaabababababababaaaaaeaeaeaaaaaaabababbiabaaawblaaaaaabmaDaaaeaeaaaCaCaaabababaaababbjababbjababababbfaaawababbjabaaaaabaaabababaaaaaaawaaaaae
aXaXaXaXaXaXaXaXaXaXaXaXaXaXaXaXaXaXaXaXaXaXaXaXaXaaaaaaaaaaabababaaababaaaaaeaeaebnaaaaabababababababaaaCaaaaaaaaaVaaaeaeaaaCaCasababbjbfabaaaaaaaaaaaaaaaaabababababababababababaeaeaeaeaeaeaaaaaaaaae
aXaXaXaXaXaXaXaXaXaXaXaXaXaXaXaXaXaXaXaXaXaXaXaXaXaaaaaaaaabababababaaaaaaaeaeaeaeaEaaababababababababaaaCaaaeaeaaaDaaaaaaaSaCaCaaabababababaaaaaaaaaeaeataaaeaeababaeaeaaaaaaaeaeaeaeaeaeaeaeaaaeaeaeae
aXaXaXaXaXaXaXaXaXaXaXaXaXaXaXaXaXaXaXaXaXaXaXaXaXaaaaaaabababababaaaaaaaeaeaeaeaaaaababababababbiababaaaCaaaeaeaaaZaAaAaAaAbbbkaabiabaaawaaaaaaaaaaaeaeaaaaaeaeaaaaaeaeaeaeaeaeaeaeaeaeaeaeaeaeaeaeaeae
aXaXaXaXaXaXaXaXaXaXaXaXaXaXaXaXaXaXaXaXaXaXaXaXaaaaaaaaababababaaaaaeaeaeaeaeaaaaabababbiabababababaaaaaCaTaeaeaaaaaaaaaaaaaTaCaaatawaaaaaaaaaaaaaeaeaeaeaeaeaeaeaeaeaeaeaeaeaeaeaeaeaeaeaeaeaeaeaeaeae
aXaXaXaXaXaXaXaXaXaXaXaXaXaXaXaXaXaXaXaXaXaXaXaXaaaaaaaaababaaaaaaaeaeaeaeaeaaaaabababababababababaaaaaaaCaaaeaeaeaaaaaaaaaaaaaCaaaaaaaaaaaaaaaaaeaeaeaeaeaeaeaeaeaeaeaeaeaeaeaeaeaeaeaeaeaeboaeaeaeaeae
aXaXaXaXaXaXaXaXaXaXaaaaaaaaaXaXaXaXaXaXaXaXaXaaaaaaaaaaabaaaaaaaeaeaeaeaaaaaaaaaaababababababaaaaaaaEaaaCaaaeaeaebpaeaaaaaaamaCasaaaaamaeaeaeaeaeaeaebdaeaeaeaeaeaeaeaeaeaeaeaeaeaeaeaeaeaeaeaeaeaeaeae
aXaXaXaXaXaXaXaXaaaaaaaaaaaaaaaXaXaXaXaXaXaXaaaaaaaaaaaaaaaaaeaeaeaeaeaeaaaaaaaaaaaaabaaaaaaaaaaaaaaaaaaaCaaaeaeaeaebqaaaaaaaaaCbfaaaaawaeaeaeaeaeaeaeaeaeaeaeaeaeaeaeaeaeaeaeaeaeaeaeaeaeaeaeaeaeaeaeae
aXaXaXaXaXaXaXaXaaaaaaaaaaaaaaaaaXaXaXaXaXaaaaaaaaaaaaaaaaaeaeaeaeaeaeaeaaaaaaaaasaaaaaaaaasaaaaaaaaaaaaaCaaaaaaaaaeaeaaaaaaaaaCaaasaaaabdaeaeaeaaaaaeaeaeaeaeaeaeaeaeaaaaaaaaaeaeaaaaaaaaaeaeaeaeaeaeaa
aXaXaXaXaXaXaXaXaaaaababababaaaaaXaXaXaXaXaaaaaaaaaaaeaeaeaeaeaeaaaaaeaeaaaaaaaaaaaaaaaaaaaaaaaaaaaaaaaaaJaKaKaPaTaaaaaaaaajaaaCbfaaaTaeaeaeaeaeaaaaaaaeaeaeaeaeaeaaaaaaaaamaaaaaaaaaaaaaaaaaeaeaeaeaaaa
aXaXaXaXaXaXaXaaaaaaabababababaaaaaaaaaaaaaaaaaaaaaaaeaeaeaeaeaaaaaaaeaeaaaaaaaaaaasaabraabsaabtaaaaaaaaaaaaaaaCaaaTaaajaaaaaaaCaaaaaaaeaeaeaaaaaaaaaaaaaaaaaaaaaaaaaaaaaaaaamaaaaaaaaaaaaaaaaaaaaaaaaaa
aXaXaXaXaXaXaXaaaaaaabababaaababaaaaaaaaaaaaaaaaaeaeaeaeaaaaaaaaaaaaaaaaasaaaaaaaaaaaabuaabvaabwaaaaaaaaaaaaaaaJaKaKaKaOaKaKaPaCasaaasaaaaaaaaamaaaaaaamaaaaaaaaaaaaasaaaaaaaaaaasaaababaaaaaaaaamaaaaaa
aXaXaXaXaXaXaaaaaaabababababababaaaaaaaaaaaaaeaeaeaeaeaeaaaaaaaaaaaaaaaaaaaaaaaaaaaaaabuaabvaabwaaaaaaaaaaaaaaaaaaaaaaaaaMaaaCaCaaaaaaabbxababababaaaaababababababbyabababababaaababaabiababbiababasaaaa
aXaXaXaXaXaXaaaaababababababababaaaaaaaaaeaeaeaeaeaeaaaaaaacacacacababaaaaaaasaaaaaaaabuaabvaabwaaaaaaaaaaaaasaaasaaaaaaaqaaaCaCaaaaawababbzababbAaabiabaaaaabbiabaabxasaaasabbiabamawbiabamaabjabbjaaaa
aXaXaXaXaXaXaaaaabababababababaaaaaeaeaeaeaeaeaeaeaaaaacacacadacacabaaaaaaaaaaaaasaaaabuaabvaabwaaaaaaaaaaaaaaaaaqaaaaaaaaaaaCaJaPaqaaabbjabbjababbyabbjbiabaaababababawbiabababbjabbjabbjabababaaabaNaK
aXaXaXaXaXaXaaaaaaababababaaaaaeaeaeaeaeaeaeaeaeaaaaacacadadadacabaaaaaaaaaaasaaaaaaaabuaabvaabwaaaaaaaaaaaaasaaaaaaaaaaaaaaaJaPaJaPaabiabababbiabababababbiabbibjababbiabababbiabababababababaaaaasaDaa
aXaXaXaXaXaaaaaaaaababaaaaaaaeaeaeaeaeaaaaaeaeaaaaaaacadadadacacaaaaaaaaaaaaaaaaasaaaabuaabvaabwaaaaaaaaaaasaaaaaaaaaaaaaaaaaaaJaPaJaKaKaKaKbBaKaKaKaKaKaKaKaKaKaKaKaKaKaKaKaKaKaKaKaKaKaKaKaKaKaKaKaLaa
aXaXaXaXaXaaaaaaabababaaaeaeaeaeaeaaaaaaaeaeaeaaaaacacadadadacaaaaaaaaaaaaaaaaaaaaaaaaaaaaaaaaaaaaasaaaaaaaaaaaaaaaaaaaaaaaaaaaaaJaKaKaKaKaKaKaKaKaKaKaKaKaKaKaKaKaKaKaKaKaKaKaKaKaKaKaKaKaKaKaKaKaKaKaK
aXaXaXaXaXaaaaababababaeaeaeaeaeaaaaaeaeaeaeaeaaaaacadadacacacaaaaaaaaaaaaaaaaaaaaaaasaaaaaaaaasaaaaaaasaaaaaaaaaaaaaaaaaaaaaaaaaaaaaaaaaaaaaaaaaaaaaaaaaaaaaaaaaaaaaaaaaaaaaaaaaaaaaaaaaaaaaaaaaaaaaaaa
aXaXaXaXaaaaaaaaabaeaeaeaeaeaeaeaeaeaeaeaeaeaaaaaaacacacacabaaaaaaaaaaaaaaaaaaaaaaaaaaaaaaaaaaaaaaaaaaaaaaaaaaaaaaaaaaaaaaaaaaaaaaaaaaaaaaaaaaaaaaaaaaaaaaaaaaaaaaaaaaaaaaaaaaaaaaaaaaaaaaaaaaaaaaaaaaaa
aXaXaaaaaaaaaaaaaeaeaeaeaeaeaeaeaeaeaeaeaaaaaaaaaaaaabababaaaaaaaaaaaaaaaaaaaaaaaaaaaaaaaaaaaaaaaaaaaaaaaaaaaaaaaaaaaaaaaaaaaaaaaaaaaaaaaaaaaaaaaaaaaaaaaaaaaaaaaaaaaaaaaaaaaaaaaaaaaaaaaaaaaaaaaaaaaaaa
aaaaaaaaaaaaaeaeaeaeaeaeaaaaaaaaaaaaaaaaababaaaaaaabababaaaaaaaaaaaaaaaaaaaaaaaaaaaaaaaaaaaaaaaaaaaaaaaaaaaaaaaaaaaaaaaaaaaaaaaaaaaaaaaaaaaaaaaaaaaaaaaaaaaaaaaaaaaaaaaaaaaaaaaaaaaaaaaaaaaaaaaaaaaaaaaa
aaaaaaaaaeaeaeaeaeaeaaaaaaaaaaababaaaaabababaaabababababaaaaaaaaaaaaaaaaaaaaaaaaaaaaaaaaaaaaaaaaaaaaaaaaaaaaaaaaaaaaaaaaaaaaaaaaaaaaaaaaaaaaaaaaaaaaaaaaaaaaaaaaaaaaaaaaaaaaaaaaaaaaaaaaaaaaaaaaaaaaaaaa
aaaaaaaeaeaeaeaeaaaaaaaaababaaabababababaaababababababaaaaaaaaaaaaaaaaaaaaaaaaaaaaaaaaaaaaaaaaaaaaaaaaaaaaaaaaaaaaaaaaaaaaaaaaaaaaaaaaaaaaaaaaaaaaaaaaaaaaaaaaaaaaaaaaaaaaaaaaaaaaaaaaaaaaaaaaaaaaaaaaaa
aaaeaeaeaeaeaaaaaaaaaaabababababababababababababababaaaaaaaaaaaaaaaaaaaaaaaaaaaaaaaaaaaaaaaaaaaaaaaaaaaaaaaaaaaaaaaaaaaaaaaaaaaaaaaaaaaaaaaaaaaaaaaaaaaaaaaaaaaaaaaaaaaaaaaaaaaaaaaaaaaaaaaaaaaaaaaaaaaa
aeaeaeaeaeaeaaaaaaabababababababababababababababaaaaaaaaaaaaaaaaaaaaaaaaaaaaaaaaaaaaaaaaaaaaaaaaaaaaaaaaaaaaaaaaaaaaaaaaaaaaaaaaaaaaaaaaaaaaaaaaaaaaaaaaaaaaaaaaaaaaaaaaaaaaaaaaaaaaaaaaaaaaaaaaaaaaaaaa
aeaeaeaeaaaaaaaaababababababababababaaaaaaababaaaaaaaaaaaaaaaaaaaaaaaaaaaaaaaaaaaaaaaaaaaaaaaaaaaaaaaaaaaaaaaaaaaaaaaaaaaaaaaaaaaaaaaaaaaaaaaaaaaaaaaaaaaaaaaaaaaaaaaaaaaaaaaaaaaaaaaaaaaaaaaaaaaaaaaaaa
aeaeaaaaaaaaaaabababababababababaaaaaaaaaaaaaaaaaaaaaaaaaaaaaaaaaaaaaaaaaaaaaaaaaaaaaaaaaaaaaaaaaaaaaaaaaaaaaaaaaaaaaaaaaaaaaaaaaaaaaaaaaaaaaaaaaaaaaaaaaaaaaaaaaaaaaaaaaaaaaaaaaaaaaaaaaaaaaaaaaaaaaaaa
aeaaaaaaaaaaababababababababababaaaaaaaaaaaaaaaaaaaaaaaaaaaaaaaaaaaaaaaaaaaaaaaaaaaaaaaaaaaaaaaaaaaaaaaaaaaaaaaaaaaaaaaaaaaaaaaaaaaaaaaaaaaaaaaaaaaaaaaaaaaaaaaaaaaaaaaaaaaaaaaaaaaaaaaaaaaaaaaaaaaaaaaa
aaaaabababababababababaaababaaaaaaaaaaaaaaaaaaaaaaaaaaaaaaaaaaaaaaaaaaaaaaaaaaaaaaaaaaaaaaaaaaaaaaaaaaaaaaaaaaaaaaaaaaaaaaaaaaaaaaaaaaaaaaaaaaaaaaaaaaaaaaaaaaaaaaaaaaaaaaaaaaaaaaaaaaaaaaaaaaaaaaaaaaaa
aaaaababababaaabababababaaaaaaaaaaaaaaaaaaaaaaaaaaaaaaaaaaaaaaaaaaaaaaaaaaaaaaaaaaaaaaaaaaaaaaaaaaaaaaaaaaaaaaaaaaaaaaaaaaaaaaaaaaaaaaaaaaaaaaaaaaaaaaaaaaaaaaaaaaaaaaaaaaaaaaaaaaaaaaaaaaaaaaaaaaaaaaaa
aaabaaababababababaaaaaaaaaaaaaaaaaaaaaaaaaaaaaaaaaaaaaaaaaaaaaaaaaaaaaaaaaaaaaaaaaaaaaaaaaaaaaaaaaaaaaaaaaaaaaaaaaaaaaaaaaaaaaaaaaaaaaaaaaaaaaaaaaaaaaaaaaaaaaaaaaaaaaaaaaaaaaaaaaaaaaaaaaaaaaaaaaaaaaa
aaababababaaaaaaaaaaaaaaaaaaaaaaaaaaaaaaaaaaaaaaaaaaaaaaaaaaaaaaaaaaaaaaaaaaaaaaaaaaaaaaaaaaaaaaaaaaaaaaaaaaaaaaaaaaaaaaaaaaaaaaaaaaaaaaaaaaaaaaaaaaaaaaaaaaaaaaaaaaaaaaaaaaaaaaaaaaaaaaaaaaaaaaaaaaaaaa
aaaaaaaaaaaaaaaaaaaaaaaaaaaaaaaaaaaaaaaaaaaaaaaaaaaaaaaaaaaaaaaaaaaaaaaaaaaaaaaaaaaaaaaaaaaaaaaaaaaaaaaaaaaaaaaaaaaaaaaaaaaaaaaaaaaaaaaaaaaaaaaaaaaaaaaaaaaaaaaaaaaaaaaaaaaaaaaaaaaaaaaaaaaaaaaaaaaaaaaa
aaaaaaaaaaaaaaaaaaaaaaaaaaaaaaaaaaaaaaaaaaaaaaaaaaaaaaaaaaaaaaaaaaaaaaaaaaaaaaaaaaaaaaaaaaaaaaaaaaaaaaaaaaaaaaaaaaaaaaaaaaaaaaaaaaaaaaaaaaaaaaaaaaaaaaaaaaaaaaaaaaaaaaaaaaaaaaaaaaaaaaaaaaaaaaaaaaaaaaaa
"}
