"aa" = (/obj/Autojoin/Clifftop/Cavewall,/turf/Basic/Obsidian,/area)
"ab" = (/obj/Autojoin/Clifftop/Cavewall,/turf/Basic/DarkDirt,/area)
"ac" = (/obj/Autojoin/Clifftop/Cavewall,/obj/Autojoin/Clifftop/Cavewall,/turf/Basic/Obsidian,/area)
"ad" = (/turf/Basic/Obsidian,/area)
"ae" = (/turf/Basic/DarkDirt,/area)
"af" = (/obj/Environment/Cave/Rocks/TallRocks/Grey,/turf/Basic/Obsidian,/area)
"ag" = (/obj/Environment/Cave/Mushrooms/Brown,/turf/Basic/DarkDirt,/area)
"ah" = (/obj/Environment/Cave/Mushrooms/Red,/turf/Basic/DarkDirt,/area)
"ai" = (/obj/Autojoin/LavaPool,/turf/Basic/Obsidian,/area)
"aj" = (/turf/Basic/Lava,/area)
"ak" = (/obj/Autojoin/Clifftop/Cavewall,/obj/Autojoin/Obsidian,/turf/Basic/DarkDirt,/area)
"al" = (/obj/Environment/Cave/Rocks/Spikes/Obsidian,/turf/Basic/Obsidian,/area)
"am" = (/obj/Autojoin/Obsidian,/turf/Basic/DarkDirt,/area)
"an" = (/obj/Environment/Cave/Rocks/Spikes/DarkDirt,/turf/Basic/DarkDirt,/area)
"ao" = (/obj/Autojoin/Dirt,/turf/Basic/DarkDirt,/area)
"ap" = (/turf/Basic/Dirt,/area)
"aq" = (/obj/Autojoin/Clifftop/Cavewall,/turf/Basic/DarkDirt,/area/NoScroll)
"ar" = (/obj/Autojoin/Clifftop/Cavewall,/obj/Autojoin/LavaPool,/turf/Basic/Obsidian,/area)
"as" = (/obj/Autojoin/Clifftop/Cavewall,/turf/Basic/Obsidian,/area/NoScroll)
"at" = (/obj/Autojoin/LavaPool,/turf/Basic/DarkDirt,/area)
"au" = (/obj/Autojoin/Clifftop/Cavewall,/obj/Autojoin/LavaPool,/turf/Basic/DarkDirt,/area)
"av" = (/obj/Autojoin/Clifftop/Cavewall,/turf/Basic/Lava,/area)
"aw" = (/turf/Basic/Clifftop/High,/area)
"ax" = (/obj/Environment/Cave/Rocks/TallRocks/Med,/turf/Basic/Clifftop/High,/area)
"ay" = (/obj/Environment/Cave/Rocks/Spikes/Dirt,/turf/Basic/Clifftop/High,/area)
"az" = (/obj/Autojoin/Clifftop/Cavewall,/obj/Environment/Cave/Rocks/LargeRocks/Alt{step_x = 28},/turf/Basic/DarkDirt,/area)
"aA" = (/obj/Environment/Cave/Rocks/SmallRocks/Dark/Single,/turf/Basic/DarkDirt,/area)
"aB" = (/obj/Autojoin/Clifftop/High,/turf/Basic/Obsidian,/area)
"aC" = (/obj/Environment/Cave/Rocks/SmallRocks/Med/Single,/turf/Basic/DarkDirt,/area)
"aD" = (/obj/Autojoin/Dirt,/obj/Autojoin/Clifftop/Cavewall,/turf/Basic/DarkDirt,/area)
"aE" = (/obj/Autojoin/Clifftop/Med,/turf/Basic/Obsidian,/area)
"aF" = (/obj/Autojoin/Clifftop/High,/obj/Autojoin/Clifftop/Med,/turf/Basic/Obsidian,/area)
"aG" = (/obj/Autojoin/Clifftop/Med,/obj/Autojoin/Clifftop/High,/turf/Basic/Clifftop/High,/area)
"aH" = (/obj/Autojoin/Clifftop/Cavewall,/obj/Environment/Cave/Rocks/SmallRocks/Med/Single{step_x = 24},/turf/Basic/DarkDirt,/area)
"aI" = (/obj/Autojoin/Clifftop/Med,/obj/Autojoin/Clifftop/High,/turf/Basic/Obsidian,/area)
"aJ" = (/obj/Environment/Cave/Rocks/LargeRocks/Alt,/turf/Basic/DarkDirt,/area)
"aK" = (/obj/Autojoin/Clifftop/Cavewall,/turf/Basic/Clifftop/High,/area)
"aL" = (/obj/Environment/Cave/Rocks/TallRocks/Med{step_x = 4},/turf/Basic/DarkDirt,/area)
"aM" = (/obj/Environment/Cave/Rocks/SmallRocks/Dark/Single{step_x = 3; step_y = 1},/turf/Basic/DarkDirt,/area)
"aN" = (/obj/Environment/Cave/Rocks/TallRocks/Med{step_x = 22},/turf/Basic/Clifftop/High,/area)
"aO" = (/obj/Autojoin/Clifftop/Cavewall,/obj/Autojoin/Dirt,/turf/Basic/DarkDirt,/area)
"aP" = (/obj/Autojoin/Dirt,/obj/Environment/Cave/Rocks/SmallRocks/Med/SingleAlt,/turf/Basic/DarkDirt,/area)
"aQ" = (/obj/Autojoin/Dirt,/obj/Environment/Cave/Rocks/LargeRocks/Alt,/turf/Basic/DarkDirt,/area)
"aR" = (/obj/Autojoin/Clifftop/Cavewall,/turf/Basic/Clifftop/Med,/area)
"aS" = (/turf/Basic/Clifftop/Med,/area)
"aT" = (/obj/Environment/Cave/Rocks/SmallRocks/Med/SingleAlt,/turf/Basic/Clifftop/Med,/area)
"aU" = (/obj/Environment/Cave/Rocks/LargeRocks/Single,/turf/Basic/Clifftop/Med,/area)
"aV" = (/obj/Environment/Cave/Rocks/Spikes/Dirt,/turf/Basic/Clifftop/Med,/area)
"aW" = (/obj/Autojoin/Clifftop/Med,/obj/Autojoin/Clifftop/Cavewall,/turf/Basic/Lava,/area)
"aX" = (/obj/Autojoin/Clifftop/Med,/turf/Basic/Lava,/area)
"aY" = (/obj/Autojoin/Clifftop/Cavewall,/obj/Autojoin/Clifftop/Med,/turf/Basic/Lava,/area)
"aZ" = (/obj/Environment/Cave/Rocks/LargeRocks/Single,/turf/Basic/DarkDirt,/area)
"ba" = (/obj/Environment/Cave/Rocks/TallRocks/Med,/turf/Basic/DarkDirt,/area)
"bb" = (/obj/Autojoin/Clifftop/Cavewall,/obj/Environment/Cave/Mushrooms/Brown,/turf/Basic/DarkDirt,/area)
"bc" = (/obj/Autojoin/Dirt,/obj/Environment/Cave/Rocks/TallRocks/Med,/turf/Basic/DarkDirt,/area)
"bd" = (/obj/Autojoin/Clifftop/Med,/obj/Autojoin/Clifftop/Cavewall,/obj/Autojoin/Clifftop/Med,/turf/Basic/Lava,/area)
"be" = (/obj/Autojoin/Clifftop/Med,/obj/Environment/Cave/Rocks/SmallRocks/Med/Single,/turf/Basic/Lava,/area)
"bf" = (/obj/Autojoin/Clifftop/Med,/obj/Environment/Cave/Rocks/SmallRocks/Med/SingleAlt,/turf/Basic/Lava,/area)
"bg" = (/obj/Environment/Cave/Rocks/SmallRocks/Dark/Stones,/turf/Basic/DarkDirt,/area)
"bh" = (/obj/Environment/Cave/Rocks/SmallRocks/Med/Single,/turf/Basic/Clifftop/Med,/area)
"bi" = (/obj/Autojoin/Dirt,/obj/MapMarker/Entrance{tag = "Entrance"},/turf/Basic/DarkDirt,/area)
"bj" = (/obj/Environment/Cave/Rocks/TallRocks/Med,/turf/Basic/Dirt,/area)
"bk" = (/obj/Autojoin/Clifftop/Cavewall,/turf/Basic/Dirt,/area/Event)
"bl" = (/turf/Basic/Dirt,/area/Event)
"bm" = (/obj/MapMarker/Event/Exit{EntranceTag = "FromCaveTest"; MapName = "dynamic/objecttest"},/turf/Basic/Dirt,/area/Event)

(1,1,1) = {"
aaaaaaaaaaaaaaaaaaaaaaaaaaaaaaaaaaaaaaaaaaaaaaaaaaaaaaaaaaaaaaaaabababababababababababababababababababababababababababababababababababababababababababababababab
acacaaaaaaaaaaaaaaaaaaaaaaaaaaaaaaaaaaaaaaaaaaaaaaaaaaaaaaaaaaaaabababababababababababababababababababababababababababababababababababababababababababababababab
aaaaaaaaaaaaadadadadadadadadadadadadadadadadadadadaaaaaaaaaaaaaaabababababababababababababababababaeaeaeaeaeaeaeaeaeaeaeabababababababababababababababababababab
aaaaadadadadadadadadadadadadadadadadadadadadadadadadadaaaaaaaaaaabababababababababababaeaeaeaeaeaeaeaeaeaeaeaeaeaeaeaeaeaeaeaeaeaeababababababababababababababab
aaaaadadadadadadadadadadadadafadadadafadadadadadadadadadaaaaaaaaabababababaeaeaeaeaeaeaeaeaeaeaeaeaeaeagaeaeaeahaeaeagaeaeaeaeaeaeaeaeaeaeababababababababababab
aaaaadadadadadadadafadadaiaiaiaiaiaiaiaiaiaiaiadadadadadaaaaaaaaababaeaeaeaeaeaeaeaeaeaeaeahaeagaeaeaeaeaeaeaeaeaeaeaeaeagaeaeaeaeaeaeaeaeaeaeababababababababab
aaaaadadadadadadaiaiaiaiaiajajajajajajajajajaiaiafadadadaaaaaaaaabaeaeaeaeaeaeaeaeagaeaeaeaeaeaeaeaeaeaeaeaeaeaeaeaeaeaeaeaeaeaeaeaeagaeaeaeaeaeabababababababab
aaaaadadadadadadaiajajajajajajajajajajajajajajaiaiadadadaaaaaaakabaeaeaeaeaeaeaeaeaeaeaeaeaeaeaeaeaeaeaeaeaeaeaeaeaeaeaeaeaeaeaeaeaeaeaeaeaeaeaeaeababababababab
aaaaadadafadadaiaiajajajajajajajajajajajajajajajaiadadaladaaaaakaeaeaeaeaeaeaeaeaeaeaeaeaeaeaeaeaeaeaeaeaeaeaeaeaeaeaeaeaeaeaeaeaeaeaeaeaeaeaeaeaeaeabababababab
aaaaadadadadadaiajajajajajajajajajajajajajajajajaiadadadadadadamaeaeaeaeaeaeaeaeaeaeaeaeaeaeaeaeaeaeaeaeaeaeaeaeaeaeaeaeaeaeaeaeaeaeaeaeaeaeaeaeaeaeabababababab
aaaaadadadadadaiajajajajajajajajajajajajajajajajaiadadadadadadamaeaeaeaeaeaeaeaeaeaeaeaeaeaeaeaeaeaeaeaeaeaeaeaeaeaeaeaeaeaeaeaeaeaeaeaeaeaeaeaeaeaeaeababababab
aaaaadadadafadaiajajajajajajajajajajajajajajajajaiadadadadadadamaeaeaeaeaeaeaeaeaeaeaeaeaeaeaeaeaeaeagaeaeaeaeaeaeaeaeaeaeaeaeaeaeaeaeaeaeaeaeaeaeaeaeababababab
aaaaadadadadadaiajajajajajajajajajajajajajajajajaiadadadadadadamaeaeaeaeaeaeaeaeaeaeaeaeaeaeaeaeaeabababaeaeahaeaeaeaeaeaeaeaeaeaeaeaeaeaeaeaeaeaeaeaeaeabababab
aaaaadadadadafaiajajajajajajajajajajajajajajajajaiafadadadadadamaeaeaeaeaeaeaeaeaeaeaeaeaeaeaeaeababababababababaeagaeaeaeaeaeaeaeaeaeaeaeaeaeaeaeaeaeaeabababab
aaaaadadadafadaiajajajajajajajajajajajajajajajaiaiadadadadaaaaakaeaeaeaeaeaeaeaeaeaeaeaeaeaeaeabababababababababababababaeaeahaeaeaeaeaeaeaeaeaeaeaeaeaeabababab
aaaaadadafadaiaiajajajajajajajajajajajajaiaiaiaiadadadadaaaaaaakabaeaeaeaeaeaeaeaeaeaeaeaeababababababababababababababababababahaeaeaeaeaeaeaeaeaeaeaeaeabababab
aaaaadadadaiaiajajajajajajajajajajajajaiaiadafadadadadalaaaaaaakababanaeaeaeaeaeaeaeaeaeabababababababababababababababababababaeaeaeaeaeaeaeaeaeaeaeaeaeabababab
aaaaadadaiaiajajajajajajajajajajajaiaiaiadadadadadadadadaaaaaaaaababaeaeaeaeaeaeaeaeaeaeabababababababababababababababababababaeaeaeaeaeaeaeaeaeaeaeaeaeabababab
aaaaadadaiajajajajajajajajajajajaiaiafadadadadadadadadadaaaaaaaaabababaeaeaeaeaeaeaeaeaeaeaeaeababababababababababababababababaeaeaeaeaeaeaeaeaeaeaeaeaeabababab
aaaaafaiaiajajajajajajajajajajaiaiadadafadadadadadadadadaaaaaaaaababababaeaeaeaeaeaeaeaeaeaeaeaeabababababababababababababababaeaeaeaeaeaeaeaeaeaeaeaeaeabababab
aaaaadaiajajajajajajajajajajajaiadadadadadadadadadadadadaaaaaaaaababababaeanaeaeaeaeaeaeaeanaeaeababababababababababababababaeaeaeaeaeaeaeaeaeaeaeaeaeababababab
aaaaadaiajajajajajajajajajajajaiadadadadadadadadadadaladaaaaaaaaabababababaeaeaeaeaoaoaeaeaeaeaeabababababababababababaeaeaeaeaeaeaeaeaeaeaeaeaeaeaeabababababab
aaaaadaiaiajajajajajajajajajajaiadadadadadadadadadadadadaaaaaaaaabababababaeaeaeaeaoaoaeaeaeaeaeaeababababababababaeaeaeaeaeaeaeaeaeaeaeaeaeaeaeaeababababababab
aaaaaaadaiajajajajajajajajajaiaiafadadadadadadadadadadadaaaaaaaaabababababaeaeaeaeaoaoaoaeaeaeaeaeaeabababababaeaeaeaeaeaeaeaeaeaeaeaeaeaeaeaeababababababababab
aaaaaaafaiajajajajajajaiaiaiaiadadadadadadadafadaladadadaaaaaaaaababababababaeaeaeaoapaoaoaeaeaeanaeaeaeaeaeaeaeaeaeaeaeaeaeaeaeaeaeaeaeaeaeabababababababababab
aaaaaaadaiaiaiaiaiaiaiaiadadadadadadadadadadadadadadadaaaaaaaaaaababababababaeaeaeaoapapaoaeaeahaeaeaeaeaeaeaeaeaeaeaeaeaeaeaeaeaeaeaeaeaeababababababababababab
aaaaaaaaadadadadafadadadadadadadafadadadadadadadadadadaaaaaaaaabababababababaeaeaeaoapapaoaoaeaeaeaeaeaeaeaeaeaeaeaeaeaeaeaeaeaeaeaeaeaeabababababababababababab
aaaaaaaaadadadadadadadadadadadadadadadadadadadadadadaaaaaaaaabababaqababababaeaeaeaoaoapapaoaoaeaeaeaeaeaeaeaeaeaeaeaeahaeaeaeaeaeaeaeababababababababababababab
aaaaaaaaadadafadadadadadadadadadadadadadadadadadalaaaaaaaaaaabababaqababababaeaeaeaeaoaoapapaoaoaoaeaeaeaeaeaeaeaeaeaeaeaeaeaeaeaeaeabababababababababababababab
aaaaaaaaadadadadadadadafadadadadadadadadadadadadadaaaaaaaaababababaqababababaeaeaeaeaeaoaoapapapaoaoaoaeaeaeaeaeaeaeaeaeaeaeaeaeababababababababababababaeaeabab
aaaaaaadadadadadadadadadadadadafadadadadadadadadaaaaaaaaabababababaqabababababaeaeaeaeaeaoaoapapapapaoaoaoaeaeaeaeaeaeaeaeaeaeabababababababababababababaeaeabab
aaaaaaadadadadadadadadadadadadadadadadadadaladaaaaaaaaaaabababababaqabababababaeaeaeaeaeaeaoaoaoapapapapaoaoaoaeaeaeaeaeaeaeabababababababababababababaeaeahabab
aaaaaaadadadadadadadaiaiadadadadadadadadaladadaaaaaaaaababababababaqababababababaeaeaeaeaeaeaeaoaoapapapapapaoaoaeaeaeaeaeaeababababababababababababaeaeaeaeabab
aaaaaaadadadadadadaiaiaiadadadadadadadadadadaaaaaaaaaaababababababaqababababababaeaeaeaeaeahaeaeaoaoaoapapapapaoaeaeaeaeaeababababababababababababaeaeaeaeaeabab
aaaaadadadadadadadaiaiaiadadadadadadadadadadaaaaaaaaaaababababababaqabababababababaeaeaeaeaeaeaeaeaeaoaoaoapapaoaoaoaeaeaeabababababababababababaeaeaeahaeaeabab
aaaaadadadadafadadadadadadadadadaladadadadaaaaaaaaaaaaababababababaqababababababababaeaeaeaeaeaeaeaeaeaeaoaoaoaoaoaoaeaeaeaeabababababababababaeaeaeaeaeaeaeabab
aaaaadadadadadadadadadadadadadadadadadadaaaaaaaaaaaaaaababababababaqababababababababababaeaeaeaeaeaeaeaeaeaeaoaoaoaeaeaeaeaeaeabababababaeaeaeaeaeaeaeaeahaeabab
aaaaadadadadadadadadaladadadadadadadadaaaaaaaaaaaaaaaaababababababaqababababababababababaeaeaeaeaeaeaeaeaeaeaeaeaeaeaeaeaeaeaeaeaeaeaeaeaeaeaeaeaeaeaeaeaeaeabab
aaaaaaadadadadadadadadadadadaladadadaaaaaaaaaaaaaaaaaaababababababaqababababababababababaeaeaeaeaeaeaeaeaeaeaeaeaeaeaeaeaeaeaeaeaeaeaeaeaeaeaeaeaeaeaeaeaeaeabab
aaaaaaadadaladadaladadadadadadadaaaaaaaaaaaaaaaaaaababababababababaqababababababababababababaeaeaeaeaeaeaeaeaeaeaeaeaeaeaeaeaeaeaeaeaeaeaeaeaeaeaeaeaeaeaeaeabab
aaaaaaadadaiaiaiaiaiaiaiaiadadaaaaaaaaaaaaaaaaaaaaababababababababaqabababababababababababababaeaeaeaeaeaeaeaeaeaeaeaeaeaeaeaeaeaeaeaeaeaeaeaeaeaeaeaeaeaeaeabab
aaaaadadadaiaiaiaiaiaiaiaiaaaaaaaaaaaaaaabaaaaaaabababababababababaqababababababababababababababababaeaeaeaeaeaeaeaeaeaeaeaeaeaeaeaeaeaeaeaeaeaeaeaeaeaeaeaeabab
aaaaaaadadaiaiaiararaaaaaaaaaaaaaaaaaaaaaaaaaaababababababababababaqababababababababababababababababababababaeaeaeaeaeaeaeaeaeaeaeaeaeaeaeaeaoaoaeaeaeaeaeaeabab
aaaaaaadadaaaaaaaaaaaaaaaaaaaaaaaaaaaaaaaaaaabababababababababababababababababababababababababababababababababababababaeaeaeaeaeaeaeaeaeaeaeaoaoaoaoaeaeaeaeabab
aaaaaaaaaaaaaaaaaaaaaaaaaaaaaaaaaaaaaaaaaaababababababababababababababababababababababababababababababababababababababababababababaeaeaeaeaeaoaoapaoaeaeaeaeabab
aaaaaaaaaaaaaaaaaaaaaaaaaaaaaaaaaaaaaaaaababababababababababababababababababababababababababababababababababababababababababababababaeaeaeaeaeaoapaoaoaeaeaeabab
aaaaaaaaaaaaaaaaaaaaaaaaaaaaaaaaaaaaaaaaabababababababababababababababababababababababababababababababababababababababababababababababaeaeaeaeaoapapaoaeaeaeabab
aqasasasasasasasasasasasasasaqaqaqaqaqaqaqaqaqaqaqaqaqaqaqababababababababababababaeaeaeaeaeaeaeaeababababababababababababababababababaeaeaeaeaoapapaoaeaeaeabab
ababababababababababababababababababababababababababababababababababababababababaeaeaeaeaeaeaeaeaeaeaeaeaeaeaeaeaeaeaeaeaeaeaeababababaeaeaeaeaoapapaoaeaeaeabab
abababababababababababababababababababababababababababababababababababababababaeaeaeaeaeaeaeaeaeaeaeaeaeaeaeaeaeaeaeaeaeaeaeaeaeaeaeaeaeaeaeaeaoapapaoaeaeaeabab
ababababababababababababababababababababababababababababababababababababaeaeaeaeaeaeaeaeaeaeaeaeaeaeaeaeaeaeaeaeaeaeaeaeaeaeaeaeaeaeaeaeaeaeaeaoapapaoaeaeaeabab
abababababababababababababababababaeaeabababababababababababababababababaeaeaeaeaeaeaeaeaeaeaeaeaeaeaeaeaeaeaeaeaeaeaeaeaeaeaeaeaeaeaeaeaeaeaeaoapapaoaeaeaeabab
ababababababababababababaeaeaeaeaeaeaeaeaeaeaeaeaeaeaeaeaeaeaeaeaeaeaeaeaeaeaeaeaeaeaeaeaeaeaoaoaoaoaoaoaoaeaeaeaeaeaeaeaeaeaeaeaeaeaeaeaeaeaoaoapapaoaeaeababab
abababababababababaeaeaeaeaeaeaeaeaeaeaeaeaeaeaeaeaeaeaeaeaeaeaeaeaeaeaeaeaeaeaeaeaeaeaeaoaoaoapapapapapaoaoaoaoaoaoaoaeaeaeaeaeaeaeaeaeaeaoaoapapaoaoaeaeababab
abababababababaeaeaeaeaeaeaeaeaeaeaeaeaeaeaeaeaeaeaeaeaeaeaeaeaeaeaeaeaeaeaeaeaeaeaeaeaoaoapapapapapapapapapapapapapaoaoaoaoaoaeaeaeaeaeaeaoapapaoaoaeaeaeababab
ababababaeaeaeaeaeaeaeaeaeaeaeaeaeaeaoaoaoaoaoaoaoaoaoaoaoaoaoaoaoaoaeaeaeaeaeaeaeaeaeaoaoaoaoaoaoaoaoaoapapapapapapapapapapaoaoaoaeaeaeaeaoaoaoaoaeaeaeabababab
ababaeaeaeaeaeaeaeaeaeaeaeaeaeaoaoaoaoapapapapapapapapapapapapaoaoaoaeaeaeaeaeaeaeaeaeaeaeaeaeaeaeaeaeaoaoaoaoaoaoapapapapapapapaoaoaeaeaeaeaeaeaeaeaeaeabababab
ababaeaeaeaeaeaeaeaeaeaeaeaeaoaoapapapapapapapapapapapapapaoaoaoaeaeaeaeaeaeaeaeaeaeaeaeaeaeaeaeaeaeaeaeaeaeaeaeaoaoaoaoaoaoapapapaoaeaeaeaeaeaeaeaeaeababababab
ababaeaeaeaeaeaeaeaeaeaoaoaoaoapapapapaoaoaoaoaoaoaoaoaoaoaoaeaeaeaeaeaeaeaeaeaeaeaeaeaeaeaeaeaeaeaeaeaeaeaeaeaeaeaeaeaeaeaoaoaoapaoaeaeaeaeaeaeaeaeabababababab
ababaeaeaeaeaeaeaeaeaoaoapapapapapapaoaoaeaeaeaeaeaeaeaeaeaeaeaeaeaeaeaeaeaeaeaeaeaeaeaeaeaeaeaeaeaeaeaeaeaeaeaeaeaeaeaeaeaeaeaoaoaoaeaeaeaeaeaeaeaeabababababab
ababaeaeaeaeaeaeaeaoaoapapapapapapaoaoaeaeaeaeaeaeaeaeaeaeaeaeaeaeaeaeaeaeaeaeaeaeaeaeaeaeaeaeaeaeaeaeaeaeaeaeaeaeaeaeaeaeaeaeaeaeaeaeaeaeaeaeaeaeababababababab
ababaeaeaeaeaeaeaeaoapapapapaoaoaoaoaeaeaeaeaeaeaeaeaeaeaeaeaeaeaeaeaeaeaeaeaeaeaeaeaeaeabababababababababaeaeaeaeaeaeaeaeaeaeaeaeaeaeaeaeaeaeaeaeababababababab
ababaeaeaeaeaeaeaeaoapapapaoaoaeaeaeaeaeaeaeaeaeaeaeaeaeaeaeaeaeaeaeaeaeaeaeaeaeabababababababababababababababababaeaeaeaeaeaeaeaeaeaeaeaeaeaeaeaeababababababab
ababaeaeaeaeaeaeaeaoapapapaoaeaeaeaeaeaeaeaeaeaeaeaeaeaeaeaeaeaeaeaeaeaeaeaeaeababababababababababababababababababababaeaeaeaeaeaeaeaeaeaeaeaeaeaeababababababab
ababaeaeaeaeaeaeaeaoapapapaoaeaeaeaeaeaeaeaeaeaeaeaeaeaeaeaeaeaeaeaeaeaeaeabababababababababababababababababababababababaeaeaeaeaeaeaeaeaeaeaeaeaeababababababab
ababaeaeaeaeaeaeaeaoapapapaoaeaeaeaeaeaeaeaeaeaeaeaeaeaeaeaeaeaeaeaeaeaeabababababababababababababababababababababababababaeaeaeaeaeaeaeaeaeaeaeaeaeabababababab
ababaeaeaeaeaeaeaeaoapapapaoaeaeaeaeaeaeabababababaeaeatatatatatatatatauauababababababababababababababababababababababababaeaeaeaeaeaeaeaeaeaeaeaeaeaeababababab
ababaeaeaeaeaeaeaeaoaoapapaoaeaeaeaeaeababababababababauajajajajajajavauauabababababababababababababababababababababababababaeaeaeaeaeaeaeaeaeaeaeaeaeababababab
ababaeaeaeaeaeaeaeaeaoaoaoaoaeaeaeaeaeababababababababauauavajajajajavauababababababababaeaeaeaeaeaeaeabababababababababababaeaeaeaeaeaeaeaoaoaoaoaeaeaeabababab
abababaeaeaeaeaeaeaeaeaoaoaeaeaeaeaeaeabababababababababauauatatatatauauabaeaeaeaeaeaeaeaeaeaeaeaeaeaeaeababababababababababaeaeaeaeaeaeaeaoapapaoaeaeaeaeababab
abababaeaeaeaeaeaeaeaeaeaeaeaeaeaeaeaeabababababababababababaeaeaeaeaeaeaeaeaeaeaeaeaeaeaeaeaeaeaeaeaeaeaeabababababababababaeaeaeaeaeaeaoaoapapaoaeaeaeaeababab
abababaeaeaeaeaeaeaeaeaeaeaeaeaeaeaeaeaeabababababababababaeaeaeaeaeaeaeaeaeaeaeaeaeaeaeaeaeaeaeaeaeaeaeaeabababababababababaeaeaeaeaeaoaoapapapaoaeaeaeaeaeabab
ababababaeaeaeaeaeaeaeaeaeaeaeaeaeaeaeaeaeababababababaeaeaeaeaeaeaeaeaeaeaeaeaeaeaeaeaeaeaeaeaeaeaeaeaeaeaeaeabababababababaeaeaeaeaeaoapapapaoaoaeaeaeaeaeabab
ababababaeaeaeaeaeaeaeaeaeaeaeaeaeaeaeaeaeababababaeaeaeaeaeaeaeaeaeaeaeaeaeaeaeaeaeaeaeababaeaeaeaeaeaeaeaeaeaeabababababaeaeaeaeaeaoaoapapapaoaeaeaeaeaeaeabab
abababababaeaeaeaeaeaeaeaeaeaeaeaeaeaeaeaeaeaeaeaeaeaeaeaeaeaeaeaeaeaeaeaeaeaeaeaeaeaeababababaeaeaeaeaeaeaeaeaeaeaeaeaeaeaeaeaeaeaoaoapapapaoaoaeaeaeaeaeaeabab
abababababababaeaeaeaeaeaeaoaoaoaoaoaoaoaoaoaoaoaoaoaoaoaoaoaoaoaoaoaoaeaeaeaeaeaeaeaeababababaeaeaeaeaeaeaeaeaeaeaeaeaeaeaeaeaeaeaoapapapapaoaeaeaeaeaeaeaeabab
ababababababababaeaeaeaoaoaoawawawawawawawaxawayawawawawawawawawawawaoaoaeaeaeaeaeaeaeabababazaeaeaAaeaeaeaeaeaeaeaeaeaoaoaoaoaoaoaoapapapaoaoaeaeaeaeaeaeababab
abababababababababaeaoaoawawawaBaBaBaBaBaBaBaBaBaBaBaBaBaBaBaBaBaBawawaoaeaeaeaeaeaeaeababababaeaCaeaAaeaeaeaeaeaeaeaeaoapapapapapapapapaoaoaeaeaeaeaeaeabababab
abababababababababaDaoawawaBaBaBadadadadadadadaEaEaEaEaEaEaEaEaEaFaGawaoaoaoaoaeaeaeaeabababaHaeanaCaeaeanaeaeaeaeaeaeaoaoaoaoaoaoapaoaoaoaeaeaeaeaeaeababababab
ababababababababaDaDawawaBaBadadadadadadadadadaEaEaEaEaEaEaEaEaEaIaGawawawawaoaeaeaeababababababaeaeaJaeaeaeabababaeaeaeaeaeaeaeaoaoaoaeaeaeaeaeaeaeaeababababab
ababababababababaDaKawaBaBadadadadadadadadadadaEaEaEaEaEaEaEaEaEaFaFaBaBaBawaoaeaeabababababababaeaeaeaLaMababababababababaeaeaeaeaeaeaeaeaeaeaeaeaeabababababab
abababababababaeaoawaBaBadadadaiaiaiaiaiadadadadadadadadadadadadaBaBaBaBaBawaoaeaeababababababababaeaeaeaeabababababababababababaeaeaeaeaeaeaeaeaeababababababab
ababababababaeaeaoaNaBadadaiaiaiajajajaiaiadaladadadadadadadadadadadadadaBawaoaeaeababababababababaeaeaeaeabababababababababababababaeaeaeaeaeaeabababababababab
abababababaeaeaeaoawaBadadaiaiaiajajajaiaiaiaiaiaiaiaiaiaiaiadadadadadadaBawaoaeaeababababababababaeaeaeaeaeabababababababababababababababababababababababababab
ababababaeaeaeaeaoawaBadadadalaiaiaiajajajajajajajajajajaiaiadadadadadaBaBawaoaeaeaeabababababababaeaeaeaeaeaeababababababababababababababababababababababababab
ababababaeaeaeaeaoawaBaBadadadadadaiaiaiajaiaiaiajajajaiaialadadadadadaBawawaoaeaeaeaeabababababaeaeaeaeaeaeaeaeaeababababababababababababababababababababababab
ababababanaeaeaeaoawawaBaBaBaBaBadadadaiaiaiadaiaiaiaiaiadadadadadaBaBaBawaoaoaeaoaoaoababababaeaeaoaoaoaeaeaeaeaeaeaeaeabababababababababababababababababababab
abababaeaeaeaeaeaoaoawawawawawaBaBaBaBaBaBaBaBaBaBaBadadadadaBaBaBaBawawawaoaeaeaoapaoaoaeaeaeaeaoaoapaoaeaeaeaeaeaeaeaeabababababababababababababababababababab
ababaeaeaeaeaeaeaeaoaoaoaoaoawawawawawawawawawawawaBaBaBaBaBaBawawawawaoaoaoaeaeaoapapaoaeaeaoaoaoapapaoaeaeaeaeaeaeaeababababababababaeaeaeaeaeaeababababababab
ababaeaeaeaeaeaeaeaeaeaeaeaoaoaoaoaoaoaoaoaoaoaoawawawawawawawawaoaoaoaoaeaeaeaeaoapapaoaoaoaoapapapaoaoaeaeaeaeaeaeaeababababababaeaeaeaeaeaeaeaeaeaeababababab
ababanaeaeaeaeaeaeaeaeaeaeaeaeaeaeaeaeaeaeaeaeaoaoaoaoaoaoaoaoaoaoaeaeaeaeaeaeaeaoapapapapapapapapaoaoaeaeaeaeaeaeabababababababaeaeaeaeaAaeaeaeaeaeaeababababab
ababaeaeaeaeaeaeaeaeaeaeaeaeaeaeaeaeaeaeaeaeaeaeaeanaeaeaeaeaeaeaeaeaeaeaeaeaeaoaoapapapapapapaoaoaoaeaeaeaeaeaeabababababababaeaeaeaeaeaeaeaeaeaeaeaeababababab
ababaeaeaeaeaeaeaeaeaeaeaeanaeaeaeaeaeaeaeaeaeaeaeaeaeaeaeaeaeaeaeaeaeaeaoaoaoaoapapapapapaoaoaoaeaeaeaeaeaeaeabababababababaeaeaeaeaeaeaeaeaeaeanaeaeaeabababab
ababaeaeaeaeaeaeaeabababababaeaeaeaeaeaeaeaeaeaeaeaeaeaeaeaeaeaeaeaeaeaeaoapapapapaoaoaoaoaoaeaeaeaeaeaeaeababababababababaeaeaeanaeaeaeaeaeaeaeaeaeaAaeaeababab
ababanaeaeaeaeaeabababababababaeaeaeaeaeaeaeaeaeaeaeaeaeaeaeaeaeaeaeaeaeaoaoaoaoaoaoaeaeaeaeaeaeaeaeaeaeababababababababaeaeaeaeaeaeaeaeaeaeaeaeaeaeaeababababab
ababaeaeaeaeaeaeabababababababaeaeaeaeaeaeaeaeaeaeaeaeaeaeaeaeaeaeaeaeaeaeaeaeaeaeaeaeaeaeaeaeaeaeaeaeaeababababababaeaeaeaeaeaeaeaeaeaeaeaeaeaeaeaeabababababab
ababaeaeaeaeaeaeaeaeaeababababaeaeaeaeaeaeaeaeaeaeaeaeanaeaeaeaeabababaOaoaoaoaoaoaoaPaoaQaoaoaoaoaPaoaOaOaOabababaeaeaAaeaeaeaeaeaeaeaeaeaeaeaeaeaeabababababab
ababaeaeaeaeaeaeaeaeaeaeaeaeaeaCaeaeaeaeaeaeaeaeaeaeaeaeabababababababaRaRaRaSaTaSaUaSaSaVaSaTaSaVaSaTaRaRabababaeaeaeaeaeaeaeaeaeaeaeaeaeaeaeaeaeaeabababababab
ababaeaeaeaeaeaeaeaeaCaeaeaeaeaeaeaeaoaoaoaoaeaeaeaeaeababababababababaWaWaWaWaXaXaXaXaXaXaXaXaXaXaXaXaWaYabababaeanaeaeaeaeaeaeaeaeaeaeaeaeaeaeaeaeaeaeabababab
abababaeaeaeaeaeaZaeaeaeaeaeaeaeaeaoaoapapaoaeaeaeababababababababababaWavavavavajajajajajajajajajajajavavabababaeaeaeaeaeaeaeaeaeaeaeaeaeaeaeaeaeaeaeaeabababab
abababaZaeaeaeaeaebaaeaeaeaeaeaeaoaoapapapaoaeanaeababababababababababaWavavavavajajajajajajajajajajajavaRabaDabababaeaeaeaeaeaeaeaeaeaeaeaeaeaAaeaeaeaeabababab
abababaeaeaeaeaeaCaeaeaeaeaeaeaeaoapapapaoaoaeaeagaeabababababababababaWavavavavajajajajajajajajajajajavaRabaDababababaeaeaeaeaeaeaeaeaeaeaeaeaeaeaeabababababab
abababaeaeaeaeaeabbbaeaeaeaeaeaobcapapaoaoaeaeaeaeaeabababababababababaWaWaWaWbdbdaXaXbeaXaXaXbfaXaXbeaWaWaRaDababababbgaeaeaeaeaeaeaeaeaeaeaeaeabababababababab
abababaeaeaeaeaeabababaeaeaeaeaoapapapaoaeaeaeaeaeaeababababababababababababaRaRaRbhaSaSbhaTbhaSaSbhaSaRaRaRaDababababaeaeaeaeaeaeaeaeaeaeaeaeababababababababab
abababaeaeaeaeaeabababaeaeanaeaoapapaoaoaeaeaeaeanaeabababababababababababababaOaOaoaoaoaoaoaoaoaQaoaoaoaDaDaDabababababaeaeaeaeaeaeaeaeaeaAaeababababababababab
abababaeaeaeaeaeabababagaeaeaeaoapapaoaeaeaeaeaeaeababababababababababababababababaeaJaeaeaeaeaeaeaeaeaeababababababababbgaeaeaeaeaeaeaeaeaeaeaeaeaeabababababab
abababaeaeaeaeababababaeaeaeaeaoapapaoaeaeaeaeaeabababababababababababababababababaeaeaeaeaeaeaeaeaeaeaeaeabababababababaeaAaeaeaeaeaeaeaeaeaeaeaeaeaeaeaeababab
abababaeaeababababababanaeaeaeaoapapaoaeaeaeaeabababababababababababababababababaeaeaeaeaeaeaeaeaeaeaeaeaeabababaeaeaeaeaeaeaeaeaeaeaeaeaeaeaeaeaeaeaeaeaeababab
abababababababababababaeaeaeaeaoapapaoaoaeaeaeababababababababababababababababaeaeaeaeaeaeaeaeaeaeaeaeaeaeaeaeaeaeaeaeaeaeaeaeaeaeaeaeaeaeaeaeaeaeaeaeaeaeababab
abababababababababababaeaeaeaeaoapapapaoaeaeaeaeababababababababababaeaeaeaeaeaeaeaeaeaeaoaoaoaoaoaoaeaeaeaeaeaeaeaeaeaeaeaeaeaeaeaeaeaeaeaeaeaeaeanaeaeaeababab
ababababababababababababaeaeaeaPaoapapaoaeaeaeaeabababababababababaeaeaeaeaeaeaeaoaoaoaoaoapapapapaoaoaeaeaeaeaeaeaeaeaeaeaeaeaeaeaeaeaeaeaeaeaeaeaeaeaeabababab
ababababaeaeaeabababababaeaeaeaeaoapaoaoaeaeaeaeaeaeaeabababababaeaeaeaeaoaoaoaoaoapapapapapaoaoaoaoaoaeaeaeaeaeaeaeaeaeaeaeaebgaeaeaeaeaeaeaeaeaeaeaeaeabababab
ababababaeaeaeaeababababaeaeaeaeaoaoaoaeaeaeaeaeaeaeaeaeaeaeaeaeaeaeaeaoaoapapapapapapaoaoaoaoaeaeaeaeaeaeaeagaeaeaeaeababababbgaeaeaeaeaeaeaeaeaeaeaeababababab
abababaeaeaeaeaeaeaeaeaeaeaeaeaeaeaeaeaeaeaeaeaeaeaeaeaeaeaeaeaeaeaeaeaoaoaoaoaoaoaoaoaoaeaeaeaeaeaeaeaeaeaeaeababababababababaeaeaeaeaeaeaeaeaeaeaeaeababababab
ababaeaeaeaeaeaeaeaeaeaeaeaeaeaeaeaeaeaeaeaeaeaeaeaeaeaeaeaeaeaeaeaeaeaeaeaeaeaeaeaeaeaeaeaeaeaeaeaeaeagaeababababababababababababaeaeaeaeaeaeaeaeaeabababababab
ababaeaeaeaeaeaeaeaeaeaeaeaeaeaeaeaeaeaeaoaobiaoaoaoaeaeaeaeaeaeaeaeaeaeaeaeaeaeaeaeaeaeaeaeaeaeaeaeaeaeabababababababababababababababaeaeaeaeaeaeababababababab
ababaeaeaeaeaeaeaeaeaeaeaeaeaeaeaeaeaoaoaoapapapbjaoaoaoaeaeaeaeaeaeaeaeaeaeaeaeaeaeaeagaeaeaeaeaeaeaeababababababababababababababababababababababababababababab
abababaeaeaeaeaeaeaeaeabababababaeaeaoapapapapapapapapaoaeaeaeaeaeaeaeaeaeaeagaeaeabababababababababaeababababababababababababababababababababababababababababab
abababababaeaeaeaeaeababababababababaOapapapapapapapapaOabababababababababababababababababababababababababababababababababababababababababababababababababababab
ababababababababababababababababababaObkblblblbmblblbkaOabababababababababababababababababababababababababababababababababababababababababababababababababababab
"}
