"aa" = (/turf/Basic/Grass,/area)
"ab" = (/turf/Autojoin/BigSand,/area)
"ac" = (/turf/Decorative/Grass,/area)
"ad" = (/obj/Foliage/PlantLife/Flowers/Crops/Cabbages,/turf/Basic/Grass,/area)
"ae" = (/obj/Foliage/PlantLife/Flowers/Crops/Carrots,/turf/Basic/Grass,/area)
"af" = (/obj/Foliage/PlantLife/Flowers/Crops/Strawberries,/turf/Basic/Grass,/area)
"ag" = (/obj/Foliage/PlantLife/Flowers/Crops/Turnips,/turf/Basic/Grass,/area)
"ah" = (/obj/Foliage/PlantLife/Flowers/Weeds,/turf/Basic/Grass,/area)
"ai" = (/obj/Foliage/Tree/DeadTree,/turf/Basic/Grass,/area)
"aj" = (/obj/Foliage/Tree/ThinTree1{step_y = 0},/turf/Basic/Grass,/area)
"ak" = (/obj/Foliage/PlantLife/Flowers/Clover,/turf/Basic/Grass,/area)
"al" = (/obj/Foliage/PlantLife/Cacti/Globular,/turf/Basic/Grass,/area)
"am" = (/obj/Foliage/PlantLife/Cacti/Paddle,/turf/Basic/Grass,/area)
"an" = (/obj/Foliage/PlantLife/Cacti/Saguaro,/turf/Basic/Grass,/area)
"ao" = (/obj/Foliage/PlantLife/Flowers/White,/turf/Basic/Grass,/area)
"ap" = (/obj/MapMarker/Entrance{tag = "ObjectTest"},/turf/Basic/Grass,/area)
"aq" = (/obj/Foliage/Tree/OakTree,/turf/Basic/Grass,/area)
"ar" = (/obj/Environment/Rock,/turf/Basic/Grass,/area)
"as" = (/obj/Environment/Stump/Mossy,/turf/Basic/Grass,/area)
"at" = (/obj/Environment/Log,/turf/Basic/Grass,/area)
"au" = (/obj/Foliage/PlantLife/Bush/LongGrass,/turf/Basic/Grass,/area)
"av" = (/obj/Foliage/PlantLife/Bush/Leafy/Small,/turf/Basic/Grass,/area)
"aw" = (/obj/Foliage/Tree/PalmTree,/turf/Autojoin/BigSand,/area)
"ax" = (/obj/Environment/CliffFace/OuterCorner/NorthWest,/turf/Basic/Grass,/area)
"ay" = (/obj/Environment/CliffFace/Side/North,/turf/Basic/Grass,/area)
"az" = (/obj/Environment/CliffFace/OuterCorner/NorthEast,/turf/Basic/Grass,/area)
"aA" = (/obj/Environment/CliffFace/Side/West,/turf/Basic/Grass,/area)
"aB" = (/obj/Environment/CliffFace/Side/East,/turf/Basic/Grass,/area)
"aC" = (/obj/Environment/Rock/Small,/turf/Basic/Grass,/area)
"aD" = (/obj/Environment/Stump/Log,/turf/Basic/Grass,/area)
"aE" = (/obj/Environment/Log/Mossy,/turf/Basic/Grass,/area)
"aF" = (/obj/Foliage/PlantLife/Bush/FlowerBush,/turf/Basic/Grass,/area)
"aG" = (/obj/Foliage/PlantLife/Bush/Leafy,/turf/Basic/Grass,/area)
"aH" = (/obj/Environment/CliffFace/OuterCorner/SouthWest,/turf/Basic/Grass,/area)
"aI" = (/obj/Environment/CliffFace/Side/South,/turf/Basic/Grass,/area)
"aJ" = (/obj/Environment/CliffFace/OuterCorner/SouthEast,/turf/Basic/Grass,/area)
"aK" = (/obj/Environment/Sign/TestSign,/obj/MapMarker/Interactible{InteractText = "Object Testing Ahead"},/turf/Basic/Grass,/area)
"aL" = (/obj/Environment/CliffFace/InnerCorner/SouthEast,/turf/Basic/Grass,/area)
"aM" = (/obj/Environment/CliffFace/Ramp/South,/turf/Basic/Grass,/area)
"aN" = (/obj/Environment/CliffFace/InnerCorner/SouthWest,/turf/Basic/Grass,/area)
"aO" = (/obj/Environment/Stump,/turf/Basic/Grass,/area)
"aP" = (/obj/Environment/Stump/Axe,/turf/Basic/Grass,/area)
"aQ" = (/obj/Foliage/PlantLife/Bush/Bush,/turf/Basic/Grass,/area)
"aR" = (/obj/Foliage/PlantLife/Bush/Fern,/turf/Basic/Grass,/area)
"aS" = (/obj/Foliage/PlantLife/Bush/Fern/Flowering,/turf/Basic/Grass,/area)
"aT" = (/obj/Environment/CliffFace/Ramp/East,/turf/Basic/Grass,/area)
"aU" = (/obj/Environment/CliffFace/Ramp/West,/turf/Basic/Grass,/area)
"aV" = (/turf/Autojoin/BigWater,/area)
"aW" = (/obj/Environment/CliffFace/InnerCorner/NorthEast,/turf/Basic/Grass,/area)
"aX" = (/obj/Environment/CliffFace/Ramp/North,/turf/Basic/Grass,/area)
"aY" = (/obj/Environment/CliffFace/InnerCorner/NorthWest,/turf/Basic/Grass,/area)
"aZ" = (/obj/MapMarker/Zone/Spawn/Attackers,/turf/Basic/Grass,/area)
"ba" = (/obj/Foliage/Tree/PineTree,/turf/Autojoin/BigSand,/area)
"bb" = (/obj/Foliage/Tree/ThinTree2,/turf/Basic/Grass,/area)
"bc" = (/obj/Foliage/Tree/PineTree,/turf/Basic/Grass,/area)
"bd" = (/obj/Foliage/Tree/ThinTree2,/turf/Autojoin/BigSand,/area)
"be" = (/obj/Environment/CliffFace/Side/North,/obj/Foliage/Tree/OakTree,/turf/Basic/Grass,/area)
"bf" = (/obj/Foliage/Tree/OakTree,/turf/Decorative/Grass,/area)
"bg" = (/obj/Foliage/PlantLife/Bush/LongGrass,/turf/Decorative/Grass,/area)
"bh" = (/obj/Environment/CliffFace/Side/West,/obj/Foliage/Tree/OakTree,/turf/Basic/Grass,/area)
"bi" = (/obj/Environment/CliffFace/Side/West,/obj/Foliage/Tree/PineTree,/turf/Basic/Grass,/area)
"bj" = (/obj/Foliage/PlantLife/Bush/Fern{step_x = 12; step_y = 14},/turf/Basic/Grass,/area)
"bk" = (/obj/Foliage/Tree/PineTree{step_x = -24; step_y = 4},/turf/Basic/Grass,/area)
"bl" = (/obj/Foliage/PlantLife/Flowers/Clover,/turf/Autojoin/BigSand,/area)
"bm" = (/obj/Foliage/PlantLife/Flowers/Weeds,/turf/Autojoin/BigSand,/area)
"bn" = (/obj/Foliage/Tree/DeadTree,/turf/Autojoin/BigSand,/area)
"bo" = (/obj/Foliage/PlantLife/Flowers/Crops/Turnips,/obj/MapMarker/Event/Dialogue{DialogueText = "Don't trample the crops!"},/turf/Basic/Grass,/area/Event)
"bp" = (/obj/Foliage/PlantLife/Flowers/Crops/Carrots,/obj/MapMarker/Event/Dialogue{DialogueText = "Don't trample the crops!"},/turf/Basic/Grass,/area/Event)
"bq" = (/obj/Foliage/PlantLife/Flowers/Crops/Cabbages,/obj/MapMarker/Event/Dialogue{DialogueText = "Don't trample the crops!"},/turf/Basic/Grass,/area/Event)
"br" = (/obj/Foliage/PlantLife/Flowers/Crops/Turnips,/turf/Basic/Grass,/area/Event)
"bs" = (/obj/Foliage/PlantLife/Flowers/Crops/Carrots,/turf/Basic/Grass,/area/Event)
"bt" = (/obj/Foliage/PlantLife/Flowers/Crops/Cabbages,/turf/Basic/Grass,/area/Event)
"bu" = (/obj/Foliage/PlantLife/Bush/Fern,/turf/Decorative/Grass,/area)
"bv" = (/obj/Foliage/Tree/PineTree,/turf/Decorative/Grass,/area)
"bw" = (/obj/Foliage/Tree/OakTree,/obj/Foliage/PlantLife/Bush/Fern,/turf/Decorative/Grass,/area)
"bx" = (/obj/Foliage/PlantLife/Flowers/Clover,/turf/Decorative/Grass,/area)
"by" = (/obj/Environment/CliffFace/Side/South,/obj/Foliage/PlantLife/Bush/Leafy/Small{step_x = 3; step_y = 18},/turf/Basic/Grass,/area)

(1,1,1) = {"
aaaaaaaaaaaaaaaaaaaaaaaaaaaaaaaaaaaaaaaaaaaaaaaaaaaaaaaaaaaaaaaaaaaaaaaaaaaaaaaaaaaaaaaaaaaaaaaaaaaaaaaaaaaaaaaaaaaaaaaaaaaaaaaaaaaaaaaaaaaaaaaaaaaaaaaaaaaaaaaaaaaaaaaaaaaaaaaaaaaaaaaaaaaaaaaaaaaaaaaa
aaaaaaaaaaaaaaaaaaaaaaaaaaaaaaaaaaaaaaaaaaaaaaaaaaaaaaaaaaaaaaaaaaaaaaaaaaaaaaaaaaaaaaaaaaaaaaaaaaaaaaaaaaaaaaaaaaaaaaaaaaaaaaaaaaaaaaaaaaaaaaaaaaaaaaaaaaaaaaaaaaaaaaaaaaaaaaaaaaaaaaaaaaaaaaaaaaaaaaaa
aaaaaaaaaaaaaaaaaaaaaaaaaaaaaaaaaaaaaaaaaaaaaaaaaaaaaaaaaaaaaaaaaaaaaaaaaaaaaaaaaaaaaaaaaaaaaaaaaaaaaaaaaaaaaaaaaaaaaaaaaaaaaaaaaaaaaaaaaaaaaaaaaaaaaaaaaaaaaaaaaaaaaaaaaaaaaaaaaaaaaaaaaaaaaaaaaaaaaaaa
aaaaaaaaaaaaaaaaaaaaaaaaaaaaaaaaaaaaaaaaaaaaaaaaaaaaaaaaaaaaaaaaaaaaaaaaaaaaaaaaaaaaaaaaaaaaaaaaaaaaaaaaaaaaaaaaaaaaaaaaaaaaaaaaaaaaaaaaaaaaaaaaaaaaaaaaaaaaaaaaaaaaaaaaaaaaaaaaaaaaaaaaaaaaaaaaaaaaaaaa
aaaaaaaaaaaaaaaaaaaaaaaaaaaaaaaaaaaaaaaaaaaaaaaaaaaaaaaaaaaaaaaaaaaaaaaaaaaaaaaaaaaaaaaaaaaaaaaaaaaaaaaaaaaaaaaaaaaaaaaaaaaaaaaaaaaaaaaaaaaaaaaaaaaaaaaaaaaaaaaaaaaaaaaaaaaaaaaaaaaaaaaaaaaaaaaaaaaaaaaa
aaaaaaaaaaaaaaaaaaaaaaaaaaaaaaaaaaaaaaaaaaaaaaaaaaaaaaaaaaaaaaaaaaaaaaaaaaaaaaaaaaaaaaaaaaaaaaaaaaaaaaaaaaaaaaaaaaaaaaaaaaaaaaaaaaaaaaaaaaaaaaaaaaaaaaaaaaaaaaaaaaaaaaaaaaaaaaaaaaaaaaaaaaaaaaaaaaaaaaaa
aaaaaaaaaaaaaaaaaaaaaaaaaaaaaaaaaaaaaaaaaaaaaaaaaaaaaaaaaaaaaaaaaaaaaaaaaaaaaaaaaaaaaaaaaaaaaaaaaaaaaaaaaaaaaaaaaaaaaaaaaaaaaaaaaaaaaaaaaaaaaaaaaaaaaaaaaaaaaaaaaaaaaaaaaaaaaaaaaaaaaaaaaaaaaaaaaaaaaaaa
aaaaaaaaaaaaaaaaaaaaaaaaaaaaaaaaaaaaaaaaaaaaaaaaaaaaaaaaaaaaaaaaaaaaaaaaaaaaaaaaaaaaaaaaaaaaaaaaaaaaaaaaaaaaaaaaaaaaaaaaaaaaaaaaaaaaaaaaaaaaaaaaaaaaaaaaaaaaaaaaaaaaaaaaaaaaaaaaaaaaaaaaaaaaaaaaaaaaaaaa
aaaaaaaaaaaaaaaaaaaaaaaaaaaaaaaaaaaaaaaaaaaaaaaaaaaaaaaaaaaaaaaaaaaaaaaaaaaaaaaaaaaaaaaaaaaaaaaaaaaaaaaaaaaaaaaaaaaaaaaaaaaaaaaaaaaaaaaaaaaaaaaaaaaaaaaaaaaaaaaaaaaaaaaaaaaaaaaaaaaaaaaaaaaaaaaaaaaaaaaa
aaaaaaaaaaaaaaaaaaaaaaaaaaaaaaaaaaaaaaaaaaaaaaaaaaaaaaaaaaaaaaaaaaaaaaaaaaaaaaaaaaaaaaaaaaaaaaaaaaaaaaaaaaaaaaaaaaaaaaaaaaaaaaaaaaaaaaaaaaaaaaaaaaaaaaaaaaaaaaaaaaaaaaaaaaaaaaaaaaaaaaaaaaaaaaaaaaaaaaaa
aaaaaaaaaaaaaaaaaaaaaaaaaaaaaaaaaaaaaaaaaaaaaaaaaaaaaaaaaaaaaaaaaaaaaaaaaaaaaaaaaaaaaaaaaaaaaaaaaaaaaaaaaaaaaaaaaaaaaaaaaaaaaaaaaaaaaaaaaaaaaaaaaaaaaaaaaaaaaaaaaaaaaaaaaaaaaaaaaaaaaaaaaaaaaaaaaaaaaaaa
aaaaaaaaaaaaaaaaaaaaaaaaaaaaaaaaaaaaaaaaaaaaaaaaaaaaaaaaaaaaaaaaaaaaaaaaaaaaaaaaaaaaaaaaaaaaaaaaaaaaaaaaaaaaaaaaaaaaaaaaaaaaaaaaaaaaaaaaaaaaaaaaaaaaaaaaaaaaaaaaaaaaaaaaaaaaaaaaaaaaaaaaaaaaaaaaaaaaaaaa
aaaaaaaaaaaaaaaaaaaaaaaaaaaaaaaaaaaaaaaaaaaaaaaaaaaaaaaaaaaaaaaaaaaaaaaaaaaaaaaaaaaaaaaaaaaaaaaaaaaaaaaaaaaaaaaaaaaaaaaaaaaaaaaaaaaaaaaaaaaaaaaaaaaaaaaaaaaaaaaaaaaaaaaaaaaaaaaaaaaaaaaaaaaaaaaaaaaaaaaa
aaaaaaaaaaaaaaaaaaaaaaaaaaaaaaaaaaaaaaaaaaaaaaaaaaaaaaaaaaaaaaaaaaaaaaaaaaaaaaaaaaaaaaaaaaaaaaaaaaaaaaaaaaaaaaaaaaaaaaaaaaaaaaaaaaaaaaaaaaaaaaaaaaaaaaaaaaaaaaaaaaaaaaaaaaaaaaaaaaaaaaaaaaaaaaaaaaaaaaaa
aaaaaaaaaaaaaaaaaaaaaaaaaaaaaaaaaaaaaaaaaaaaaaaaaaaaaaaaaaaaaaaaaaaaaaaaaaaaaaaaaaaaaaaaaaaaaaaaaaaaaaaaaaaaaaaaaaaaaaaaaaaaaaaaaaaaaaaaaaaaaaaaaaaaaaaaaaaaaaaaaaaaaaaaaaaaaaaaaaaaaaaaaaaaaaaaaaaaaaaa
aaaaaaaaaaaaaaaaaaaaaaaaaaaaaaaaaaaaaaaaaaaaaaaaaaaaaaaaaaaaaaaaaaaaaaaaaaaaaaaaaaaaaaaaaaaaaaaaaaaaaaaaaaaaaaaaaaaaaaaaaaaaaaaaaaaaaaaaaaaaaaaaaaaaaaaaaaaaaaaaaaaaaaaaaaaaaaaaaaaaaaaaaaaaaaaaaaaaaaaa
aaaaaaaaaaaaaaaaaaaaaaaaaaaaaaaaaaaaaaaaaaaaaaaaaaaaaaaaaaaaaaaaaaaaaaaaaaaaaaaaaaaaaaaaaaaaaaaaaaaaaaaaaaaaaaaaaaaaaaaaaaaaaaaaaaaaaaaaaaaaaaaaaaaaaaaaaaaaaaaaaaaaaaaaaaaaaaaaaaaaaaaaaaaaaaaaaaaaaaaa
aaaaaaaaaaaaaaaaaaaaaaaaaaaaaaaaaaaaaaaaaaaaaaaaaaaaaaaaaaaaaaaaaaaaaaaaaaaaaaaaaaaaaaaaaaaaaaaaaaaaaaaaaaaaaaaaaaaaaaaaaaaaaaaaaaaaaaaaaaaaaaaaaaaaaaaaaaaaaaaaaaaaaaaaaaaaaaaaaaaaaaaaaaaaaaaaaaaaaaaa
aaaaaaaaaaaaaaaaaaaaaaaaaaaaaaaaaaaaaaaaaaaaaaaaaaaaaaaaaaaaaaaaaaaaaaaaaaaaaaaaaaaaaaaaaaaaaaaaaaaaaaaaaaaaaaaaaaaaaaaaaaaaaaaaaaaaaaaaaaaaaaaaaaaaaaaaaaaaaaaaaaaaaaaaaaaaaaaaaaaaaaaaaaaaaaaaaaaaaaaa
aaaaaaaaaaaaaaaaaaaaaaaaaaaaaaaaaaaaaaaaaaaaaaaaaaaaaaaaaaaaaaaaaaaaaaaaaaaaaaaaaaaaaaaaaaaaaaaaaaaaaaaaaaaaaaaaaaaaaaaaaaaaaaaaaaaaaaaaaaaaaaaaaaaaaaaaaaaaaaaaaaaaaaaaaaaaaaaaaaaaaaaaaaaaaaaaaaaaaaaa
aaaaaaaaaaaaaaaaaaaaaaaaaaaaaaaaaaaaaaaaaaaaaaaaaaaaaaaaaaaaaaaaaaaaaaaaaaaaaaaaaaaaaaaaaaaaaaaaaaaaaaaaaaaaaaaaaaaaaaaaaaaaaaaaaaaaaaaaaaaaaaaaaaaaaaaaaaaaaaaaaaaaaaaaaaaaaaaaaaaaaaaaaaaaaaaaaaaaaaaa
aaaaaaaaaaaaaaaaaaaaaaaaaaaaaaaaaaaaaaaaaaaaaaaaaaaaaaaaaaaaaaaaaaaaaaaaaaaaaaaaaaaaaaaaaaaaaaaaaaaaaaaaaaaaaaaaaaaaaaaaaaaaaaaaaaaaaaaaaaaaaaaaaaaaaaaaaaaaaaaaaaaaaaaaaaaaaaaaaaaaaaaaaaaaaaaaaaaaaaaa
aaaaaaaaaaaaaaaaaaaaaaaaaaaaaaaaaaaaaaaaaaaaaaaaaaaaaaaaaaaaaaaaaaaaaaaaaaaaaaaaaaaaaaaaaaaaaaaaaaaaaaaaaaaaaaaaaaaaaaaaaaaaaaaaaaaaaaaaaaaaaaaaaaaaaaaaaaaaaaaaaaaaaaaaaaaaaaaaaaaaaaaaaaaaaaaaaaaaaaaa
aaaaaaaaaaaaaaaaaaaaaaaaaaaaaaaaaaaaaaaaaaaaaaaaaaaaaaaaaaaaaaaaaaaaaaaaaaaaaaaaaaaaaaaaaaaaaaaaaaaaaaaaaaaaaaaaaaaaaaaaaaaaaaaaaaaaaaaaaaaaaaaaaaaaaaaaaaaaaaaaaaaaaaaaaaaaaaaaaaaaaaaaaaaaaaaaaaaaaaaa
aaaaaaaaaaaaaaaaaaaaaaaaaaaaaaaaaaaaaaaaaaaaaaaaaaaaaaaaaaaaaaaaaaaaaaaaaaaaaaaaaaaaaaaaaaaaaaaaaaaaaaaaaaaaaaaaaaaaaaaaaaaaaaaaaaaaaaaaaaaaaaaaaaaaaaaaaaaaaaaaaaaaaaaaaaaaaaaaaaaaaaaaaaaaaaaaaaaaaaaa
aaaaaaaaaaaaaaaaaaaaaaaaaaaaaaaaaaaaaaaaaaaaaaaaaaaaaaaaaaaaaaaaaaaaaaaaaaaaaaaaaaaaaaaaaaaaaaaaaaaaaaaaaaaaaaaaaaaaaaaaaaaaaaaaaaaaaaaaaaaaaaaaaaaaaaaaaaaaaaaaaaaaaaaaaaaaaaaaaaaaaaaaaaaaaaaaaaaaaaaa
aaaaaaaaaaaaaaaaaaaaaaaaaaaaaaaaaaaaaaaaaaaaaaaaaaaaaaaaaaaaaaaaaaaaaaaaaaaaaaaaaaaaaaaaaaaaaaaaaaaaaaaaaaaaaaaaaaaaaaaaaaaaaaaaaaaaaaaaaaaaaaaaaaaaaaaaaaaaaaaaaaaaaaaaaaaaaaaaaaaaaaaaaaaaaaaaaaaaaaaa
aaaaaaaaaaaaaaaaaaaaaaaaaaaaaaaaaaaaaaaaaaaaaaaaaaaaaaaaaaaaaaaaaaaaaaaaaaaaaaaaaaaaaaaaaaaaaaaaaaaaaaaaaaaaaaaaaaaaaaaaaaaaaaaaaaaaaaaaaaaaaaaaaaaaaaaaaaaaaaaaaaaaaaaaaaaaaaaaaaaaaaaaaaaaaaaaaaaaaaaa
aaaaaaaaaaaaaaaaaaaaaaaaaaaaaaaaaaaaaaaaaaaaaaaaaaaaaaaaaaaaaaaaaaaaaaaaaaaaaaaaaaaaaaaaaaaaaaaaaaaaaaaaaaaaaaaaaaaaaaaaaaaaaaaaaaaaaaaaaaaaaaaaaaaaaaaaaaaaaaaaaaaaaaaaaaaaaaaaaaaaaaaaaaaaaaaaaaaaaaaa
aaaaaaaaaaaaaaaaaaaaaaaaaaaaaaaaaaaaaaaaaaaaaaaaaaaaaaaaaaaaaaaaaaaaaaabababababababababababaaaaaaaaaaaaaaaaaaaaaaaaaaaaaaaaaaaaaaaaaaaaaaaaaaaaaaaaaaaaaaaaaaaaaaaaaaaaaaaaaaaaaaaaaaaaaaaaaaaaaaaaaaaa
aaaaaaaaaaaaaaaaaaaaaaaaaaaaaaaaaaaaaaaaaaaaaaaaaaaaaaaaaaabababababababababababababababababaaaaaaaaaaaaaaaaaaaaaaaaaaaaaaaaaaaaaaaaaaaaaaaaaaaaaaaaaaaaaaaaaaaaaaaaaaaaaaaaaaaaaaaaaaaaaaaaaaaaaaaaaaaa
aaaaaaaaaaaaaaaaaaaaaaaaaaaaaaaaaaaaaaaaaaaaaaaaaaaaaaaaaaabababababababababababababababababaaaaaaaaaaaaaaaaaaaaaaaaaaaaaaaaaaaaaaaaaaaaaaaaaaaaaaaaaaaaaaaaaaaaaaaaaaaaaaaaaaaaaaaaaaaaaaaaaaaaaaaaaaaa
aaaaaaaaaaaaaaaaaaaaaaaaaaaaaaaaaaaaaaaaaaaaaaaaaaaaaaaaaaabababababababababababababababababaaaaaaaaaaaaaaaaaaaaaaaaaaaaaaaaaaaaaaaaaaaaaaaaaaaaaaaaaaaaaaaaaaaaaaaaaaaaaaaaaaaaaaaaaaaaaaaaaaaaaaaaaaaa
aaaaaaaaaaaaaaaaaaaaaaaaaaaaaaaaaaaaaaaaaaaaaaaaaaaaaaaaaaaaaaaaaaaaaaababababaaaaaaababababaaaaaaaaaaaaaaaaaaaaaaaaaaaaaaaaaaaaaaaaaaaaaaaaaaaaaaaaaaaaaaaaaaaaaaaaaaaaaaaaaaaaaaaaaaaaaaaaaaaaaaaaaaaa
aaaaaaaaaaaaaaaaaaaaaaaaaaaaaaaaaaaaaaaaaaaaaaaaaaaaaaaaaaaaaaaaaaaaaaababababaaaaaaababababaaaaaaaaaaaaaaaaaaaaaaaaaaaaaaaaaaaaaaaaaaaaaaaaaaaaaaaaaaaaaaaaaaaaaaaaaaaaaaaaaaaaaaaaaaaaaaaaaaaaaaaaaaaa
aaaaaaaaaaaaaaaaaaaaaaaaaaaaaaaaaaaaaaaaaaaaaaaaaaaaaaaaaaaaaaaaaaaaaaababababaaaaaaababababaaaaaaaaaaaaaaaaaaaaaaaaaaaaaaaaaaaaaaaaaaaaaaaaaaaaaaaaaaaaaaaaaaaaaaaaaaaaaaaaaaaaaaaaaaaaaaaaaaaaaaaaaaaa
aaaaaaaaaaaaaaaaaaaaaaaaaaaaaaaaaaaaaaaaaaaaaaaaaaaaaaaaaaaaaaaaaaaaaaaaaaaaaaaaaaaaaaaaaaaaaaaaaaaaaaaaaaaaaaaaaaaaaaaaaaaaaaaaaaaaaaaaaaaaaaaaaaaaaaaaaaaaaaaaaaaaaaaaaaaaaaaaaaaaaaaaaaaaaaaaaaaaaaaa
aaaaaaaaaaaaaaaaaaaaaaaaaaaaaaaaaaaaaaacacacacacacacacacacacacacacacaaaaaaaaaaaaaaaaaaaaaaaaaaaaaaaaaaaaaaaaaaaaaaaaaaaaaaaaaaaaaaaaaaaaaaaaaaaaaaaaaaaaaaaaaaaaaaaaaaaaaaaaaaaaaaaaaaaaaaaaaaaaaaaaaaaa
aaaaaaaaaaaaaaaaaaaaaaaaaaaaaaaaaaaaaaacacacacacacacacacacacacacacacaaaaaaaaaaaaaaaaaaaaaaaaaaaaaaaaaaaaaaaaaaaaaaaaaaaaaaaaaaaaaaaaaaadadaaaeaeaaafafaaagagaaahahaaaaaaaaaaaaaaaaaaaaaaaaaaaaaaaaaaaaaa
aaaaaaaaaaaaaaaaaaaaaaaaaaaaaaaaaaaaaaacacacacacacacacacacacacacacacaaaaaaaaaaaaaiaaaaaaaiaaaiaaaaaiaiaiaaaaaaaaaaajaaaaajaaajaaajajajadadaaaeaeaaafafaaagagaaahahaaaaaaaaaaaaaaaaaaaaaaaaaaaaaaaaaaaaaa
aaaaaaaaaaaaaaaaaaaaaaaaaaaaaaaaaaaaaaacacacacacacacacacacacacacacacaaaaaiaaaaaiaaaiaaaaaaaiaaaaaaaiaiaiaaaaajaaajaaajaaaaajaaaaajajajaaaaaaaaaaaaaaaaaaaaaaaaaaaaaaaaaaaaaaaaaaaaaaaaaaaaaaaaaaaaaaaaaa
aaaaaaaaaaaaaaaaaaaaaaaaaaaaaaaaaaaaaaacacacacacacacacacacacacacacacaaaaaaaaaaaaaiaaaaaaaiaaaiaaaaaiaiaiaaaaaaaaaaajaaaaajaaajaaajajajakakaaalalaaamamaaananaaaoaoaaaaaaaaaaaaaaaaaaaaaaaaaaaaaaaaaaaaaa
aaaaaaaaaaaaaaaaaaaaaaaaaaaaaaaaaaaaaaacacacacacacacacacacacacacacacaaaaaaaaaaaaaaaaaaaaaaaaaaaaaaaaaaaaaaaaabababababababababababaaaaakakaaalalaaamamaaananaaaoaoaaaaaaaaaaaaaaaaaaaaaaaaaaaaaaaaaaaaaa
aaaaaaaaaaaaaaaaaaaaaaaaaaaaaaaaaaaaaaacacacacacacacacacacacacacacacaaaaaaaaaaaaapaaaaaaaaaaaaaaaaaaaaaaaaaaabababababababababababaaaaaaaaaaaaaaaaaaaaaaaaaaaaaaaaaaaaaaaaaaaaaaaaaaaaaaaaaaaaaaaaaaaaaa
aaaaaaaaaaaaaaaaaaaaaaaaaaaaaaaaaaaaaaacacacacacacacacacacacacacacacaaaaaqaaaaaaaaaaaaaaaaaaaaaaaaaaaaaaaaaaabababababababababababaaaaararaaasasaaataaaaauauaaavavaaaaaaaaaaaaaaaaaaaaaaaaaaaaaaaaaaaaaa
aaaaaaaaaaaaaaaaaaaaaaaaaaaaaaaaaaaaaaacacacacacacacacacacacacacacacaaaaaaaaaaaaaaaaaaababababaaaaababaaaaaaababababababawabawababaaaaararaaasasaaataaaaauauaaavavaaaxayazaaaaaaaaaaaaaaaaaaaaaaaaaaaaaa
aaaaaaaaaaaaaaaaaaaaaaaaaaaaaaaaaaaaaaacacacacacacacacacacacacacacacaaaaaaaaaaaaaaaaaaababababaaaaababaaaaaaababawababababawabababaaaaaaaaaaaaaaaaaaaaaaaaaaaaaaaaaaaAaaaBaaaaaaaaaaaaaaaaaaaaaaaaaaaaaa
aaaaaaaaaaaaaaaaaaaaaaaaaaaaaaaaaaaaaaacacacacacacacacacacacacacacacaaaaaqaaaaaaaaaaaaababababababababaaaaaaababababababawabawababaaaaaCaCaaaDaDaaaEaaaaaFaFaaaGaGaaaHaIaJaaaaaaaaaaaaaaaaaaaaaaaaaaaaaa
aaaaaaaaaaaaaaaaaaaaaaaaaaaaaaaaaaaaaaacacacacacacacacacacacacacacacaaaqaaaqaaaaaaaaaaababababababababaaaaaaabababababababababababaaaaaCaCaaaDaDaaaEaaaaaFaFaaaGaGaaaaaaaaaaaaaaaaaaaaaaaaaaaaaaaaaaaaaa
aaaaaaaaaaaaaaaaaaaaaaaaaaaaaaaaaaaaaaaaaaaaaaaaaaaaaaaaaaaaaaaaaaaaaaaaaqaaaaaaaaaaaaaaaaaaaaaaaaaKaaaaaaaaabababababababababababaaaaaaaaaaaaaaaaaaaaaaaaaaaaaaaaaaaLaMaNaaaaaaaaaaaaaaaaaaaaaaaaaaaaaa
aaaaaaaaaaaaaaaaaaaaaaaaaaaaaaaaaaaaaaaaaaaaaaaaaaaaaaaaaaaaaaaaaaaaaaaaaaaaaaaaaaaaaaaaaaaaaaaaaaaaaaaaaaaaabababababababababababaaaaaOaOaaaPaPaaaQaQaaaRaRaaaSaSaaaTaaaUaaaaaaaaaaaaaaaaaaaaaaaaaaaaaa
aaaaaaaaaaaaaaaaaaaaaaaaaaaaaaaaaaaaaaaaaVaVaVaVaVaVaVaaaaaaaaaaaaaaaaaaaaaaaaaaaaababaaaaaaaaaaaaaaaaaaaaaaababawabababawawawababaaaaaOaOaaaPaPaaaQaQaaaRaRaaaSaSaaaWaXaYaaaaaaaaaaaaaaaaaaaaaaaaaaaaaa
aaaaaaaaaaaaaaaaaaaaaaaaaaaaaaaaaaaaaaaVaVaVaVaVaVaVaVaVaaaaaaaaaaaaaaaqaqaqaaaaabababaaaaaaaaaaaaaaaaaaaaaaabawabawababawawawababaaaaaaaaaaaaaaaaaaaaaaaaaaaaaaaaaaaaaaaaaaaaaaaaaaaaaaaaaaaaaaaaaaaaaa
aaaaaaaaaaaaaaaaaaaaaaaaaaaaaaaaaaaaaaaVaVaVaVaVaVaVaVaVaVaaaaaaaaaaaaaqaqaqaaaaabababaZaaaaaaaaaaaaaaaaaaaaababawabababawawawababaaaaaaaaaaaaaaaaaaaaaaaaaaaaaaaaaaaaaaaaaaaaaaaaaaaaaaaaaaaaaaaaaaaaaa
aaaaaaaaaaaaaaaaaaaaaaaaaaaaaaaaaaaaaaaVaVaVaVaVaVaVaVaVaVaaaaaaaaaaaaaqaqaqaaaaabababaaaaaaaaaaaaaaaaaaaaaaabababababababababababaaaaaaaaaaaaaaaaaaaaaaaaaaaaaaaaaaaaaaaaaaaaaaaaaaaaaaaaaaaaaaaaaaaaaa
aaaaaaaaaaaaaaaaaaaaaaaaaaaaaaaaaaaaaVaVaVaVaVaVaVaVaVaVaVaaaaaaaaaaaaaaaaaaaaaaababaaababaaababaaaaaaaaaaaaababababaaaaaaaaaaaaaaaaaaaaaaaaaaaaaaaaaaaaaaaaaaaaaaaaaaaaaaaaaaaaaaaaaaaaaaaaaaaaaaaaaaaa
aaaaaaaaaaaaaaaaaaaaaaaaaaaaaaaaaaaaaVaVaVaVaVaVaVaVaVaVaVaaaaaaaaaaaaaaaaaaaaaaababababababababaaaaaaaaaaababababababaaaaaaaaaaaaaaaaaaaaaaaaaaaaaaaaaaaaaaaaaaaaaaaaaaaaaaaaaaaaaaaaaaaaaaaaaaaaaaaaaa
aaaaaaaaaaaaaaaaaaaaaaaaaaaaaaaaaaaVaVaVaVaVaVaVaVaVaVaVaVaaaaaaaaaaaaaqaaaqaaaaabababababbaabababbababaaaabbaabbaabababaaaabbaaaabbaabbaabbbbbbaaaaaaaaaaaaaaaaaaaaaaaaaaaaaaaaaaaaaaaaaaaaaaaaaaaaaaaa
aaaaaaaaaaaaaaaaaaaaaaaaaaaaaaaaaaaVaVaVaVaVaVaVaVaVaVaVaaaaaaaaaaaaaaaaaqaaaaaaaabcaaaabaabbaababbababaabababbaabababbdaabbaabbaaaabbaaaabbbbbbaaaaaaaaaaaaaaaaaaaaaaaaaaaaaaaaaaaaaaaaaaaaaaaaaaaaaaaa
aaaaaaaaaaaaaaaaaaaaaaaaaaaaaaaaaaaVaVaVaVaVaVaVaVaVaVaVaaaaaaaaaaaaaaaqaaaqaaaaaaaaaaababbaabababbcbabaababbaabbaabababaaaabbaaaabbaabbaabbbbbbaaaaaaaaaaaaaaaaaaaaaaaaaaaaaaaaaaaaaaaaaaaaaaaaaaaaaaaa
aaaaaaaaaaaaaaaaaaaaaaaaaaaaaaaaaVaVaVaVaVaVaVaVaVaVaVaVaaaaaaaaaaaaaaaaaaaaaaaaaaabababababaaababaaaaabababababaaaaababaaaaaxayayayayayayayayayayayayayayayayayayayayayayayayayayayayayayayayayayayayay
aaaaaaaaaaaaaaaaaaaaaaaaaaaaaaaVaVaVaVaVaVaVaVaVaVaVaVaVaaaaaaaaaaaaaaaaaaaaaaaaabababababaaaaaaaaaaaaababaaaaaaaaaaaaaaaaaQaAaxaybeayayayayayayayayaybeayayayayaybeayayayayayayayaybeayayayayayaybeayay
aVaVaVaaaaaaaaaaaaaaaaaaaaaaaVaVaVaVaVaVaVaVaVaVaVaVaVaaaaaaaaaaaaaaaaaaaaaaaaaaabababaaaaaaaCaaaaaaaaaaaaaaaaaaaaaaaaababaaaAaAaaaaaaaabfacacbfacacbfacacacacaaaaaaaaaaaaaaaqacacacacacbfacacacaaaaaaaa
aVaVaVaVaVaVaaaaaaaaaVaVaVaVaVaVaVaVaVaVaVaVaVaVaVaVaVaaaaaaaaaaaaaaaaaaaaaaaaaaababaaaaaaaaaaaaaaaaaaaaaaauaaaaaaaaaaababaaaAaAaaaaacacacaaaaacacacaaacacacbfacacbfacacbfacacaaaaacbgacacacbfacacacacaa
aVaVaVaVaVaVaVaVaVaVaVaVaVaVaVaVaVaVaVaVaVaVaVaVaVaVaaaaaaaaaaaaaaaqaaaaaaaaaaabababaaaaaaaaaaaaaaaaaaaaaxayayayayazaQaaaaaaaAbhaabfacacaqbgacaaaqacbfacaabgacacacaaacacaaaabgacacbfacacbgacacaaacacauaa
aVaVaVaVaVaVaVaVaVaVaVaVaVaVaVaVaVaVaVaVaVaVaVaVaVaVaaaaaaaaaaaaaaaaaaaaaaaaaaabababaaaaaaaaaaaaaqaaaaaubiaaaaaabjaBaaababaaaAaAaaacacacaaacacbgacacbgacacacacbcaaauacacbgacaaaaacaaacacacaaaaaaauaaaaab
aVaVaVaVaVaVaVaVaVaVaVaVaVaVaVaVaVaVaVaVaVaVaVaVaVaaaaaaaaaaaaaaaaaaaaaaaaaaabababbkaaaaaaaaaaaaaaaaaaaaaAaaaaaaaaaTaaababaaaAaAaqacacbgbcacaaaaaaaaaaaaaaaaacacacacacacacacacacacababababababaaaaaaaaab
aVaVaVaVaVaVaVaVaVaVaVaVaVaVaVaVaVaVaVaVaVaVaVaVaVaaaaaaaaaaaaaaaaaaaaaaaaababababaCaaaaaaaaaaaaaaaaaaaaaAaaababaaaBaaaaaaaQaAaAaaacacacacacaaaaaaaaababaraaababacacababaaaaaaababababababababaaabababab
aVaVaVaVaVaVaVaVaVaVaVaVaVaVaVaVaVaVaVaVaVaVaVaVaVaaaaaaaaaaaaaaaaaaaaaaababababaaaaaaaaaaaaaaaaaqaaaaaaaAaaababaaaWayayayayaYbhaabfacaaauaaaaaaaaaaababaaaaababaaaaabababababababababababababababababab
aVaVaVaVaVaVaVaVaVaVaVaVaVaVaVaVaVaVaVaVaVaVaVaVaaaaaaaaaaaaaaaaaaaaabababababaaaaaaaaaaaqaaaaaaaaaaaaaaaAaRababaaaaaaaaaaaaaRaAaaarauaaaaaaaaaaaaababababababababababababababababababababababababababab
aVaVaVaVaVaVaVaVaVaVaVaVaVaVaVaVaVaVaVaVaVaVaVaVaaaaaaaaaaaaaaaaaaabababababaaaaaaaaaaaaaaaaaaaaaaaaaaaaaAaaabababaaaaaaaaaaaaaAaaaaaaaaaaaaaaaaababababababababababababababababababababababblababababab
aVaVaVaVaVaVaVaVaVaVaaaaaaaaaVaVaVaVaVaVaVaVaVaaaaaaaaaaaaaaaaaaababababaaaaaaaaaaaaaaaaaaaaaaaaaaaaaCaaaAaaabababbmabaaaaaaakaAaqaaaaakabababababababbaabababababababababababababababababababababababab
aVaVaVaVaVaVaVaVaaaaaaaaaaaaaaaVaVaVaVaVaVaVaaaaaaaaaaaaaaaaababababababaaaaaaaaaaaaaaaaaaaaaaaaaaaaaaaaaAaaababababbnaaaaaaaaaAbcaaaaauabababababababababababababababababababababababababababababababab
aVaVaVaVaVaVaVaVaaaaaaaaaaaaaaaaaVaVaVaVaVaaaaaaaaaaaaaaaaabababababababaaaaaaaaaqaaaaaaaaaqaaaaaaaaaaaaaAaaaaaaaaababaaaaaaaaaAaaaqaaaabaabababaaaaabababababababababaaaaaaaaababaaaaaaaaababababababaa
aVaVaVaVaVaVaVaVaaaaaaaaaaaaaaaaaVaVaVaVaVaaaaaaaaaaababababababaaaaababaaaaaaaaaaaaaaaaaaaaaaaaaaaaaaaaaHaIaIaNaRaaaaaaaaahaaaAbcaaaRabababababaaaaaaababababababaaaaaaaaakaaaaaaaaaaaaaaaaababababaaaa
aVaVaVaVaVaVaVaaaaaaaaaaaaaaaaaaaaaaaaaaaaaaaaaaaaaaabababababaaaaaaababaaaaaaaaaaaqaaboaabpaabqaaaaaaaaaaaaaaaAaaaRaaahaaaaaaaAaaaaaaabababaaaaaaaaaaaaaaaaaaaaaaaaaaaaaaaaakaaaaaaaaaaaaaaaaaaaaaaaaaa
aVaVaVaVaVaVaVaaaaaaaaaaaaaaaaaaaaaaaaaaaaaaaaaaababababaaaaaaaaaaaaaaaaaqaaaaaaaaaaaabraabsaabtaaaaaaaaaaaaaaaHaIaIaIaMaIaIaNaAaqaaaqaaaaaaaaakaaaaaaakaaaaaaaaaaaaaqaaaaaaaaaaaqaaacacaaaaaaaaakaaaaaa
aVaVaVaVaVaVaaaaaaaaaaaaaaaaaaaaaaaaaaaaaaaaababababababaaaaaaaaaaaaaaaaaaaaaaaaaaaaaabraabsaabtaaaaaaaaaaaaaaaaaaaaaaaaaKaaaAaAaaaaaaacbuacacacacaaaaacacacacacacbvacacacacacaaacacaabfacacbfacacaqaaaa
aVaVaVaVaVaVaaaaaaaaaaaaaaaaaaaaaaaaaaaaababababababaaaaaaaaaaaaaaaaaaaaaaaaaqaaaaaaaabraabsaabtaaaaaaaaaaaaaqaaaqaaaaaaaoaaaAaAaaaaauacacbwacacbxaabfacaaaaacbfacaabuaqaaaqacbfacakaubfacakaabgacbgaaaa
aVaVaVaVaVaVaaaaaaaaaaaaaaaaaaaaaaababababababababaaaaaaaaaaaaaaaaaaaaaaaaaaaaaaaqaaaabraabsaabtaaaaaaaaaaaaaaaaaoaaaaaaaaaaaAaHaNaoaaacbgacbgacacbvacbgbfacaaacacacacaubfacacacbgacbgacbgacacacaaacaLaI
aVaVaVaVaVaVaaaaaaaaaaaaaaaaaaabababababababababaaaaaaaaaaaaaaaaaaaaaaaaaaaaaqaaaaaaaabraabsaabtaaaaaaaaaaaaaqaaaaaaaaaaaaaaaHaNaHaNaabfacacacbfacacacacacbfacbfbgacacbfacacacbfacacacacacacacaaaaaqaBaa
aVaVaVaVaVaaaaaaaaaaaaaaaaaaabababababaaaaababaaaaaaaaaaaaaaaaaaaaaaaaaaaaaaaaaaaqaaaabraabsaabtaaaaaaaaaaaqaaaaaaaaaaaaaaaaaaaHaNaHaIaIaIaIbyaIaIaIaIaIaIaIaIaIaIaIaIaIaIaIaIaIaIaIaIaIaIaIaIaIaIaIaJaa
aVaVaVaVaVaaaaaaaaaaaaaaabababababaaaaaaabababaaaaaaaaaaaaaaaaaaaaaaaaaaaaaaaaaaaaaaaaaaaaaaaaaaaaaqaaaaaaaaaaaaaaaaaaaaaaaaaaaaaHaIaIaIaIaIaIaIaIaIaIaIaIaIaIaIaIaIaIaIaIaIaIaIaIaIaIaIaIaIaIaIaIaIaIaI
aVaVaVaVaVaaaaaaaaaaaaabababababaaaaabababababaaaaaaaaaaaaaaaaaaaaaaaaaaaaaaaaaaaaaaaqaaaaaaaaaqaaaaaaaqaaaaaaaaaaaaaaaaaaaaaaaaaaaaaaaaaaaaaaaaaaaaaaaaaaaaaaaaaaaaaaaaaaaaaaaaaaaaaaaaaaaaaaaaaaaaaaaa
aVaVaVaVaaaaaaaaaaabababababababababababababaaaaaaaaaaaaaaaaaaaaaaaaaaaaaaaaaaaaaaaaaaaaaaaaaaaaaaaaaaaaaaaaaaaaaaaaaaaaaaaaaaaaaaaaaaaaaaaaaaaaaaaaaaaaaaaaaaaaaaaaaaaaaaaaaaaaaaaaaaaaaaaaaaaaaaaaaaaa
aVaVaaaaaaaaaaaaababababababababababababaaaaaaaaaaaaaaaaaaaaaaaaaaaaaaaaaaaaaaaaaaaaaaaaaaaaaaaaaaaaaaaaaaaaaaaaaaaaaaaaaaaaaaaaaaaaaaaaaaaaaaaaaaaaaaaaaaaaaaaaaaaaaaaaaaaaaaaaaaaaaaaaaaaaaaaaaaaaaaaa
aaaaaaaaaaaaababababababaaaaaaaaaaaaaaaaaaaaaaaaaaaaaaaaaaaaaaaaaaaaaaaaaaaaaaaaaaaaaaaaaaaaaaaaaaaaaaaaaaaaaaaaaaaaaaaaaaaaaaaaaaaaaaaaaaaaaaaaaaaaaaaaaaaaaaaaaaaaaaaaaaaaaaaaaaaaaaaaaaaaaaaaaaaaaaaa
aaaaaaaaababababababaaaaaaaaaaaaaaaaaaaaaaaaaaaaaaaaaaaaaaaaaaaaaaaaaaaaaaaaaaaaaaaaaaaaaaaaaaaaaaaaaaaaaaaaaaaaaaaaaaaaaaaaaaaaaaaaaaaaaaaaaaaaaaaaaaaaaaaaaaaaaaaaaaaaaaaaaaaaaaaaaaaaaaaaaaaaaaaaaaaa
aaaaaaabababababaaaaaaaaaaaaaaaaaaaaaaaaaaaaaaaaaaaaaaaaaaaaaaaaaaaaaaaaaaaaaaaaaaaaaaaaaaaaaaaaaaaaaaaaaaaaaaaaaaaaaaaaaaaaaaaaaaaaaaaaaaaaaaaaaaaaaaaaaaaaaaaaaaaaaaaaaaaaaaaaaaaaaaaaaaaaaaaaaaaaaaaa
aaabababababaaaaaaaaaaaaaaaaaaaaaaaaaaaaaaaaaaaaaaaaaaaaaaaaaaaaaaaaaaaaaaaaaaaaaaaaaaaaaaaaaaaaaaaaaaaaaaaaaaaaaaaaaaaaaaaaaaaaaaaaaaaaaaaaaaaaaaaaaaaaaaaaaaaaaaaaaaaaaaaaaaaaaaaaaaaaaaaaaaaaaaaaaaaa
ababababababaaaaaaaaaaaaaaaaaaaaaaaaaaaaaaaaaaaaaaaaaaaaaaaaaaaaaaaaaaaaaaaaaaaaaaaaaaaaaaaaaaaaaaaaaaaaaaaaaaaaaaaaaaaaaaaaaaaaaaaaaaaaaaaaaaaaaaaaaaaaaaaaaaaaaaaaaaaaaaaaaaaaaaaaaaaaaaaaaaaaaaaaaaaa
ababababaaaaaaaaaaaaaaaaaaaaaaaaaaaaaaaaaaaaaaaaaaaaaaaaaaaaaaaaaaaaaaaaaaaaaaaaaaaaaaaaaaaaaaaaaaaaaaaaaaaaaaaaaaaaaaaaaaaaaaaaaaaaaaaaaaaaaaaaaaaaaaaaaaaaaaaaaaaaaaaaaaaaaaaaaaaaaaaaaaaaaaaaaaaaaaaa
ababaaaaaaaaaaaaaaaaaaaaaaaaaaaaaaaaaaaaaaaaaaaaaaaaaaaaaaaaaaaaaaaaaaaaaaaaaaaaaaaaaaaaaaaaaaaaaaaaaaaaaaaaaaaaaaaaaaaaaaaaaaaaaaaaaaaaaaaaaaaaaaaaaaaaaaaaaaaaaaaaaaaaaaaaaaaaaaaaaaaaaaaaaaaaaaaaaaaa
abaaaaaaaaaaaaaaaaaaaaaaaaaaaaaaaaaaaaaaaaaaaaaaaaaaaaaaaaaaaaaaaaaaaaaaaaaaaaaaaaaaaaaaaaaaaaaaaaaaaaaaaaaaaaaaaaaaaaaaaaaaaaaaaaaaaaaaaaaaaaaaaaaaaaaaaaaaaaaaaaaaaaaaaaaaaaaaaaaaaaaaaaaaaaaaaaaaaaaa
aaaaaaaaaaaaaaaaaaaaaaaaaaaaaaaaaaaaaaaaaaaaaaaaaaaaaaaaaaaaaaaaaaaaaaaaaaaaaaaaaaaaaaaaaaaaaaaaaaaaaaaaaaaaaaaaaaaaaaaaaaaaaaaaaaaaaaaaaaaaaaaaaaaaaaaaaaaaaaaaaaaaaaaaaaaaaaaaaaaaaaaaaaaaaaaaaaaaaaaa
aaaaaaaaaaaaaaaaaaaaaaaaaaaaaaaaaaaaaaaaaaaaaaaaaaaaaaaaaaaaaaaaaaaaaaaaaaaaaaaaaaaaaaaaaaaaaaaaaaaaaaaaaaaaaaaaaaaaaaaaaaaaaaaaaaaaaaaaaaaaaaaaaaaaaaaaaaaaaaaaaaaaaaaaaaaaaaaaaaaaaaaaaaaaaaaaaaaaaaaa
aaaaaaaaaaaaaaaaaaaaaaaaaaaaaaaaaaaaaaaaaaaaaaaaaaaaaaaaaaaaaaaaaaaaaaaaaaaaaaaaaaaaaaaaaaaaaaaaaaaaaaaaaaaaaaaaaaaaaaaaaaaaaaaaaaaaaaaaaaaaaaaaaaaaaaaaaaaaaaaaaaaaaaaaaaaaaaaaaaaaaaaaaaaaaaaaaaaaaaaa
aaaaaaaaaaaaaaaaaaaaaaaaaaaaaaaaaaaaaaaaaaaaaaaaaaaaaaaaaaaaaaaaaaaaaaaaaaaaaaaaaaaaaaaaaaaaaaaaaaaaaaaaaaaaaaaaaaaaaaaaaaaaaaaaaaaaaaaaaaaaaaaaaaaaaaaaaaaaaaaaaaaaaaaaaaaaaaaaaaaaaaaaaaaaaaaaaaaaaaaa
aaaaaaaaaaaaaaaaaaaaaaaaaaaaaaaaaaaaaaaaaaaaaaaaaaaaaaaaaaaaaaaaaaaaaaaaaaaaaaaaaaaaaaaaaaaaaaaaaaaaaaaaaaaaaaaaaaaaaaaaaaaaaaaaaaaaaaaaaaaaaaaaaaaaaaaaaaaaaaaaaaaaaaaaaaaaaaaaaaaaaaaaaaaaaaaaaaaaaaaa
aaaaaaaaaaaaaaaaaaaaaaaaaaaaaaaaaaaaaaaaaaaaaaaaaaaaaaaaaaaaaaaaaaaaaaaaaaaaaaaaaaaaaaaaaaaaaaaaaaaaaaaaaaaaaaaaaaaaaaaaaaaaaaaaaaaaaaaaaaaaaaaaaaaaaaaaaaaaaaaaaaaaaaaaaaaaaaaaaaaaaaaaaaaaaaaaaaaaaaaa
"}
