"aa" = (/turf/Floor/Exterior{tag = "icon-1,10"; icon_state = "1,10"},/area)
"ab" = (/turf/Floor/Exterior{tag = "icon-4,11"; icon_state = "4,11"},/area)
"ac" = (/turf/Floor/Exterior{tag = "icon-0,5"; icon_state = "0,5"},/area)
"ad" = (/turf/Floor/Exterior{tag = "icon-Bush0"; icon_state = "Bush0"},/area)
"ae" = (/turf/Floor/Exterior{tag = "icon-0,4"; icon_state = "0,4"},/area)
"af" = (/turf/Floor/Exterior{tag = "icon-1,4"; icon_state = "1,4"},/area)
"ag" = (/turf/Floor/Exterior/Sand{tag = "icon-N,W,NWi"; icon_state = "N,W,NWi"},/area)
"ah" = (/turf/Floor/Exterior/Sand{tag = "icon-N"; icon_state = "N"},/area)
"ai" = (/turf/Floor/Exterior/Sand{tag = "icon-N,E,NEi"; icon_state = "N,E,NEi"},/area)
"aj" = (/turf/Floor/Exterior{tag = "icon-0,3"; icon_state = "0,3"},/area)
"ak" = (/turf/Floor/Exterior{tag = "icon-1,3"; icon_state = "1,3"},/area)
"al" = (/turf/Floor/Exterior/Sand{tag = "icon-W"; icon_state = "W"},/area)
"am" = (/turf/Floor/Exterior/Sand{tag = "icon-SandBase"; icon_state = "SandBase"},/area)
"an" = (/turf/Floor/Exterior/Sand{tag = "icon-E"; icon_state = "E"},/area)
"ao" = (/turf/Floor/Foliage/Tree{tag = "icon-TreeD3"; icon_state = "TreeD3"},/area)
"ap" = (/turf/Floor/Foliage/Tree{tag = "icon-TreeD4"; icon_state = "TreeD4"},/area)
"aq" = (/turf/Floor/Exterior/Sand{tag = "icon-S,W,SWi"; icon_state = "S,W,SWi"},/area)
"ar" = (/turf/Floor/Exterior/Sand{tag = "icon-S"; icon_state = "S"},/area)
"as" = (/turf/Floor/Exterior/Sand{tag = "icon-SWe"; icon_state = "SWe"},/area)
"at" = (/turf/Floor/Foliage/Tree{tag = "icon-TreeD1"; icon_state = "TreeD1"},/area)
"au" = (/turf/Floor/Foliage/Tree{tag = "icon-TreeD2"; icon_state = "TreeD2"},/area)
"av" = (/turf/Floor/Exterior{tag = "icon-2,4"; icon_state = "2,4"},/area)
"aw" = (/turf/Floor/Exterior{tag = "icon-3,4"; icon_state = "3,4"},/area)
"ax" = (/turf/Floor/Exterior{tag = "icon-2,3"; icon_state = "2,3"},/area)
"ay" = (/turf/Floor/Exterior{tag = "icon-3,3"; icon_state = "3,3"},/area)
"az" = (/turf/Floor/Exterior/Sand{tag = "icon-S,E,SEi"; icon_state = "S,E,SEi"},/area)
"aA" = (/turf/Floor/Exterior{tag = "icon-0,7"; icon_state = "0,7"},/area)
"aB" = (/turf/Floor/Exterior{tag = "icon-1,7"; icon_state = "1,7"},/area)
"aC" = (/turf/Floor/Exterior{tag = "icon-0,6"; icon_state = "0,6"},/area)
"aD" = (/turf/Floor/Exterior{tag = "icon-1,6"; icon_state = "1,6"},/area)
"aE" = (/turf/Floor/Exterior/Sand{tag = "icon-SandBorderN,E,W,NWi,NEi"; icon_state = "SandBorderN,E,W,NWi,NEi"},/area)
"aF" = (/turf/Floor/Foliage/Tree{tag = "icon-TreeD2,3"; icon_state = "TreeD2,3"},/area)
"aG" = (/turf/Floor/Exterior/Sand{tag = "icon-SandBorderE,W"; icon_state = "SandBorderE,W"},/area)
"aH" = (/turf/Floor/Exterior{tag = "icon-Bush10"; icon_state = "Bush10"},/area)
"aI" = (/turf/Floor/Exterior/Sand{tag = "icon-N,W,NWi,SEe"; icon_state = "N,W,NWi,SEe"},/area)
"aJ" = (/turf/Floor/Exterior/Sand{tag = "icon-S,E,SEi,NWe"; icon_state = "S,E,SEi,NWe"},/area)
"aK" = (/turf/Floor/Exterior{tag = "icon-Bush"; icon_state = "Bush"},/area)
"aL" = (/turf/Floor/Exterior{tag = "icon-Bush9"; icon_state = "Bush9"},/area)
"aM" = (/turf/Floor/Exterior/Sand{tag = "icon-NWe,E"; icon_state = "NWe,E"},/area)
"aN" = (/turf/Floor/Foliage/Bush,/area)
"aO" = (/turf/Floor/Foliage/Tree{tag = "icon-TreeD4,1"; icon_state = "TreeD4,1"},/area)
"aP" = (/turf/Floor/Foliage/Flowers{tag = "icon-Flowers2"; icon_state = "Flowers2"},/area)
"aQ" = (/turf/Floor/Exterior{tag = "icon-6,7"; icon_state = "6,7"},/area)
"aR" = (/turf/Floor/Exterior{tag = "icon-7,7"; icon_state = "7,7"},/area)
"aS" = (/turf/Floor/Exterior{tag = "icon-7,8"; icon_state = "7,8"},/area)
"aT" = (/turf/Floor/Exterior/Sand{tag = "icon-NWe"; icon_state = "NWe"},/area)
"aU" = (/turf/Floor/Exterior{tag = "icon-Bush6"; icon_state = "Bush6"},/area)
"aV" = (/turf/Floor/Exterior{tag = "icon-6,6"; icon_state = "6,6"},/area)
"aW" = (/turf/Floor/Exterior{tag = "icon-7,6"; icon_state = "7,6"},/area)
"aX" = (/turf/Floor/Exterior/Sand{tag = "icon-SEe"; icon_state = "SEe"},/area)
"aY" = (/turf/Floor/Exterior/Sand{tag = "icon-SWe,E"; icon_state = "SWe,E"},/area)
"aZ" = (/turf/Floor/Exterior/Sand{tag = "icon-SandBorderSN,E,W,SWi,SEi"; icon_state = "SandBorderSN,E,W,SWi,SEi"},/area)
"ba" = (/turf/Floor/Foliage/Bush{tag = "icon-Bush3"; icon_state = "Bush3"},/area)
"bb" = (/turf/Floor/Foliage/Bush{tag = "icon-Bush4"; icon_state = "Bush4"},/area)
"bc" = (/turf/Floor/Foliage/Stump,/area)
"bd" = (/turf/Floor/Foliage/Bush{tag = "icon-Bush9"; icon_state = "Bush9"},/area)
"be" = (/turf/Floor/Foliage/Flowers,/area)
"bf" = (/turf/Floor/Exterior{tag = "icon-Bush5"; icon_state = "Bush5"},/area)
"bg" = (/turf/Floor/Exterior/Sand{tag = "icon-SandBorderS,N,W,SWi,NWi"; icon_state = "SandBorderS,N,W,SWi,NWi"},/area)
"bh" = (/turf/Floor/Exterior/Sand{tag = "icon-SandBaseSWe,NWe,NEe"; icon_state = "SandBaseSWe,NWe,NEe"},/area)
"bi" = (/obj/MapMarker/Zone/Spawn/Attackers,/turf/Floor/Exterior{tag = "icon-1,10"; icon_state = "1,10"},/area)
"bj" = (/turf/Floor/Foliage/Bush{tag = "icon-Bush2"; icon_state = "Bush2"},/area)
"bk" = (/turf/Floor/Exterior{tag = "icon-1,8"; icon_state = "1,8"},/area)

(1,1,1) = {"
aaaaaaaaaaaaaaaaaaaaaaaaaaaaaaaaaaaaaaaaaaaaaaaaaaaaaaaaaaaaaaaaaaaaaaaaaaaaaaaaaaaaaaaaaaaaaaaaaaaaaaaaaaaaaaaaaaaaaaaaaaaaaaaaaaaaaaaaaaaaaaaaaaaaaaaaaaaaaaaa
aaaaaaaaaaaaaaaaaaaaaaaaaaaaaaaaaaaaaaaaaaaaaaaaaaaaaaaaaaaaaaaaaaaaaaaaaaaaaaaaaaaaaaaaaaaaaaaaaaaaaaaaaaaaaaaaaaaaaaaaaaaaaaaaaaaaaaaaaaaaaaaaaaaaaaaaaaaaaaaa
aaaaaaaaaaaaaaaaaaaaaaaaaaaaaaaaaaaaaaaaaaaaaaaaaaaaaaaaaaaaaaaaaaaaaaaaaaaaaaaaaaaaaaaaaaaaaaaaaaaaaaaaaaaaaaaaaaaaaaaaaaaaaaaaaaaaaaaaaaaaaaaaaaaaaaaaaaaaaaaa
aaaaaaaaaaaaaaaaaaaaaaaaaaaaaaaaaaaaaaaaaaaaaaaaaaaaaaaaaaaaaaaaaaaaaaaaaaaaaaaaaaaaaaaaaaaaaaaaaaaaaaaaaaaaaaaaaaaaaaaaaaaaaaaaaaaaaaaaaaaaaaaaaaaaaaaaaaaaaaaa
aaaaaaaaaaaaaaaaaaaaaaaaaaaaaaaaaaaaaaaaaaaaaaaaaaaaaaaaaaaaaaaaaaaaaaaaaaaaaaaaaaaaaaaaaaaaaaaaaaaaaaaaaaaaaaaaaaaaaaaaaaaaaaaaaaaaaaaaaaaaaaaaaaaaaaaaaaaaaaaa
aaaaaaaaaaaaaaaaaaaaaaaaaaaaaaaaaaaaaaaaaaaaaaaaaaaaaaaaaaaaaaaaaaaaaaaaaaaaaaaaaaaaaaaaaaaaaaaaaaaaaaaaaaaaaaaaaaaaaaaaaaaaaaaaaaaaaaaaaaaaaaaaaaaaaaaaaaaaaaaa
aaaaaaaaaaaaaaaaaaaaaaaaaaaaaaaaaaaaaaaaaaaaaaaaaaaaaaaaaaaaaaaaaaaaaaaaaaaaaaaaaaaaaaaaaaaaaaaaaaaaaaaaaaaaaaaaaaaaaaaaaaaaaaaaaaaaaaaaaaaaaaaaaaaaaaaaaaaaaaaa
aaaaaaaaaaaaaaaaaaaaaaaaaaaaaaaaaaaaaaaaaaaaaaaaaaaaaaaaaaaaaaaaaaaaaaaaaaaaaaaaaaaaaaaaaaaaaaaaaaaaaaaaaaaaaaaaaaaaaaaaaaaaaaaaaaaaaaaaaaaaaaaaaaaaaaaaaaaaaaaa
aaaaaaaaaaaaaaaaaaaaaaaaaaaaaaaaaaaaaaaaaaaaaaaaaaaaaaaaaaaaaaaaaaaaaaaaaaaaaaaaaaaaaaaaaaaaaaaaaaaaaaaaaaaaaaaaaaaaaaaaaaaaaaaaaaaaaaaaaaaaaaaaaaaaaaaaaaaaaaaa
aaaaaaaaaaaaaaaaaaaaaaaaaaaaaaaaaaaaaaaaaaaaaaaaaaaaaaaaaaaaaaaaaaaaaaaaaaaaaaaaaaaaaaaaaaaaaaaaaaaaaaaaaaaaaaaaaaaaaaaaaaaaaaaaaaaaaaaaaaaaaaaaaaaaaaaaaaaaaaaa
aaaaaaaaaaaaaaaaaaaaaaaaaaaaaaaaaaaaaaaaaaaaaaaaaaaaaaaaaaaaaaaaaaaaaaaaaaaaaaaaaaaaaaaaaaaaaaaaaaaaaaaaaaaaaaaaaaaaaaaaaaaaaaaaaaaaaaaaaaaaaaaaaaaaaaaaaaaaaaaa
aaaaaaaaaaaaaaaaaaaaaaaaaaaaaaaaaaaaaaaaaaaaaaaaaaaaaaaaaaaaaaaaaaaaaaaaaaaaaaaaaaaaaaaaaaaaaaaaaaaaaaaaaaaaaaaaaaaaaaaaaaaaaaaaaaaaaaaaaaaaaaaaaaaaaaaaaaaaaaaa
aaaaaaaaaaaaaaaaaaaaaaaaaaaaaaaaaaaaaaaaaaaaaaaaaaaaaaaaaaaaaaaaaaaaaaaaaaaaaaaaaaaaaaaaaaaaaaaaaaaaaaaaaaaaaaaaaaaaaaaaaaaaaaaaaaaaaaaaaaaaaaaaaaaaaaaaaaaaaaaa
aaaaaaaaaaaaaaaaaaaaaaaaaaaaaaaaaaaaaaaaaaaaaaaaaaaaaaaaaaaaaaaaaaaaaaaaaaaaaaaaaaaaaaaaaaaaaaaaaaaaaaaaaaaaaaaaaaaaaaaaaaaaaaaaaaaaaaaaaaaaaaaaaaaaaaaaaaaaaaaa
aaaaaaaaaaaaaaaaaaaaaaaaaaaaaaaaaaaaaaaaaaaaaaaaaaaaaaaaaaaaaaaaaaaaaaaaaaaaaaaaaaaaaaaaaaaaaaaaaaaaaaaaaaaaaaaaaaaaaaaaaaaaaaaaaaaaaaaaaaaaaaaaaaaaaaaaaaaaaaaa
aaaaaaaaaaaaaaaaaaaaaaaaaaaaaaaaaaaaaaaaaaaaaaaaaaaaaaaaaaaaaaaaaaaaaaaaaaaaaaaaaaaaaaaaaaaaaaaaaaaaaaaaaaaaaaaaaaaaaaaaaaaaaaaaaaaaaaaaaaaaaaaaaaaaaaaaaaaaaaaa
aaaaaaaaaaaaaaaaaaabaaaaaaaaaaaaaaaaaaaaaaaaabaaaaaaaaaaaaaaaaaaaaaaaaaaaaaaaaaaaaaaaaaaaaaaaaaaaaaaaaaaaaabaaaaaaaaaaaaaaaaaaaaaaaaaaaaaaaaaaaaaaaaaaaaaaaaaaaa
aaaaaaaaaaaaaaaaaaaaaaaaaaaaaaaaaaaaaaaaaaaaaaaaaaaaaaaaaaaaaaaaaaaaaaaaaaaaaaaaaaaaaaaaaaaaaaaaaaaaaaaaaaaaaaaaaaaaaaaaaaaaaaaaaaaaaaaaaaaaaaaaaaaaaaaaaaaaaaaa
aaaaaaaaaaaaaaaaaaaaaaaaaaaaaaaaaaaaaaaaaaaaaaaaaaaaaaaaaaaaaaaaaaaaaaaaaaaaaaaaaaaaaaaaaaaaaaaaaaaaaaaaaaaaaaaaaaaaaaaaaaaaaaaaaaaaaaaaaaaaaaaaaaaaaaaaaaaaaaaa
aaaaaaaaaaaaaaaaaaaaaaaaaaaaaaaaaaaaaaaaaaaaaaaaaaaaaaaaaaaaaaaaaaaaaaaaaaaaaaaaaaaaaaaaaaaaaaaaaaaaaaaaaaaaaaaaaaaaaaaaaaaaaaaaaaaaaaaaaaaaaaaaaaaaaaaaaaaaaaaa
aaaaaaaaaaaaaaaaaaaaaaaaaaaaaaaaaaaaaaaaaaaaaaaaaaaaaaaaaaaaaaaaaaaaaaaaaaaaaaaaaaaaaaaaaaaaaaaaaaaaaaaaaaaaaaaaaaaaaaaaaaaaaaaaaaaaaaaaaaaaaaaaaaaaaaaaaaaaaaaa
aaaaaaaaaaaaaaaaaaaaaaaaaaaaaaaaaaaaaaaaaaaaaaaaaaaaaaaaaaaaaaaaaaaaaaaaaaaaaaaaaaaaaaaaaaaaaaaaaaaaaaaaaaaaaaaaaaaaaaaaaaaaaaaaaaaaaaaaaaaaaaaaaaaaaaaaaaaaaaaa
aaaaaaaaaaaaaaaaaaaaaaaaaaaaaaaaaaaaaaaaaaaaaaaaaaaaaaaaaaaaaaaaaaaaaaaaaaaaaaaaaaaaaaaaaaaaaaaaaaaaaaaaaaaaaaaaaaaaaaaaaaaaaaaaaaaaaaaaaaaaaaaaaaaaaaaaaaaaaaaa
aaaaaaaaaaaaaaaaaaaaaaaaaaaaaaaaaaaaaaaaaaaaaaaaaaaaaaaaaaaaaaaaaaaaaaaaaaaaaaaaaaaaaaaaaaaaaaaaaaaaaaaaaaaaaaaaaaaaaaaaaaaaaaaaaaabaaaaaaaaaaaaaaaaaaaaaaaaaaaa
aaaaaaaaaaaaaaaaaaaaaaaaaaaaaaaaaaaaaaaaaaaaaaaaaaaaaaaaaaaaaaaaaaaaaaaaaaaaaaaaaaaaaaaaaaaaaaaaaaaaaaaaaaaaaaaaaaaaaaaaaaaaaaaaaaaaaaaaaaaaaaaaaaaaaaaaaaaaaaaa
aaaaaaaaaaaaaaaaaaaaaaaaaaaaaaaaaaaaaaaaaaaaaaaaaaaaaaaaaaaaaaaaaaaaaaaaaaaaaaaaaaaaaaaaaaaaaaaaaaaaaaaaaaaaaaaaaaaaaaaaaaaaaaaaaaaaaaaaaaaaaaaaaaaaaaaaaaaaaaaa
aaaaaaaaaaaaaaaaaaaaaaaaaaaaaaaaaaaaaaaaaaaaaaaaaaaaaaaaaaaaaaaaaaaaaaaaaaaaaaaaaaaaaaaaaaaaaaaaaaaaaaaaaaaaaaaaaaaaaaaaaaaaaaaaaaaaaaaaaaaaaaaaaaaaaaaaaaaaaaaa
aaaaaaaaaaaaaaaaaaaaaaaaaaaaaaaaaaaaaaaaaaaaaaaaaaaaaaaaaaaaaaaaaaaaaaaaaaaaaaaaaaaaaaaaaaaaaaaaaaaaaaabaaaaaaaaaaaaaaaaaaaaaaaaaaaaaaaaaaaaaaaaaaaaaaaaaaaaaaaa
aaaaaaaaaaaaaaaaaaaaaaaaaaaaaaaaaaaaaaaaaaaaaaaaaaaaaaaaaaaaaaaaaaaaaaaaaaaaaaaaaaaaaaaaaaaaaaaaaaaaaaaaaaaaaaaaaaaaaaaaaaaaaaaaaaaaaaaaaaaaaaaaaaaaaaaaaaaaaaaa
aaaaaaaaaaaaaaaaaaaaaaaaaaaaaaaaaaaaaaaaaaaaaaaaaaaaaaabaaaaaaaaaaaaaaaaaaaaaaaaaaaaaaaaaaaaaaaaaaaaaaaaaaaaaaaaaaaaaaaaaaaaaaaaaaaaaaaaaaaaaaaaaaaaaaaaaaaaaaaa
aaaaaaaaaaaaaaaaaaaaaaaaaaaaaaaaaaaaaaaaaaaaaaaaaaaaaaaaaaaaaaaaaaaaaaaaaaaaaaaaaaaaaaaaaaaaaaaaaaaaaaaaaaaaaaaaaaaaaaaaaaaaaaaaaaaaaaaaaaaaaaaaaaaaaaaaaaaaaaaa
aaaaaaaaaaaaaaaaaaaaaaaaaaaaaaaaaaaaaaaaaaaaaaaaaaaaaaaaaaaaaaaaaaaaaaaaaaaaaaaaaaaaaaaaaaaaaaaaaaaaaaaaaaaaaaaaaaaaaaaaaaaaaaaaaaaaaaaaaaaaaaaaaaaaaaaaaaaaaaaa
aaaaaaaaaaaaaaaaaaaaaaaaaaaaaaaaaaaaaaaaaaaaaaaaaaaaaaaaaaaaaaaaaaaaaaaaaaaaaaaaaaaaaaaaaaaaaaaaaaaaaaaaaaaaaaaaaaaaaaaaaaaaaaaaaaaaaaaaaaaaaaaaaaaaaaaaaaaaaaaa
aaaaaaaaaaaaaaaaaaaaaaaaaaaaaaaaaaaaaaaaaaaaaaaaaaaaaaaaaaaaaaaaaaaaaaaaaaaaaaaaaaaaaaaaaaaaaaaaaaaaaaaaaaaaaaaaaaaaaaaaaaaaaaaaaaaaaaaaaaaaaaaaaaaaaaaaaaaaaaaa
aaaaaaaaaaaaaaaaaaaaaaaaaaaaaaaaaaaaaaaaaaaaaaaaaaaaaaaaaaaaaaaaaaaaaaaaaaaaaaaaaaaaaaaaaaaaaaaaaaaaaaaaaaaaaaaaaaaaaaaaaaaaaaaaaaaaaaaaaaaaaaaaaaaaaaaaaaaaaaaa
aaaaaaaaaaaaaaaaaaaaaaaaaaaaaaaaaaaaaaaaaaaaaaaaaaaaaaaaaaaaaaaaaaaaaaaaaaaaaaaaaaabaaaaaaaaaaaaaaaaaaaaaaaaaaaaaaaaaaaaaaaaaaaaaaaaaaaaabaaaaaaaaaaaaaaaaaaaaaa
aaaaaaaaaaaaaaaaaaaaaaaaaaaaaaaaaaaaaaaaaaaaaaaaaaaaaaaaaaaaaaaaaaaaaaaaaaaaaaaaaaaaaaaaaaaaaaaaaaaaaaaaaaaaaaaaaaaaaaaaaaaaaaaaaaaaaaaaaaaaaaaaaaaaaaaaaaaaaaaa
aaaaaaaaaaaaaaaaaaaaaaaaaaaaaaaaaaaaaaaaaaaaaaaaaaaaaaaaaaaaaaaaaaaaaaaaaaaaaaaaaaaaaaaaaaaaaaaaaaaaaaaaaaaaaaaaaaaaaaaaaaaaaaaaaaaaaaaaaaaaaaaaaaaaaaaaaaaaaaaa
aaaaaaaaaaaaaaaaaaaaaaaaaaaaaaaaaaaaaaaaaaaaaaaaaaaaaaaaaaaaaaaaaaaaaaaaaaaaaaaaaaaaaaaaaaaaaaaaaaaaaaaaaaaaaaaaaaaaaaaaaaaaaaaaaaaaaaaaaaaaaaaaaaaaaaaaaaaaaaaa
aaaaaaaaaaaaaaaaaaaaaaaaaaaaaaaaaaaaaaaaaaaaaaaaaaaaaaaaaaaaaaaaaaaaaaaaaaaaaaaaaaaaaaaaaaaaaaaaaaaaaaaaaaaaaaaaaaaaaaaaaaaaaaaaaaaaaaaaaaaaaaaaaaaaaaaaaaaaaaaa
aaaaaaaaaaaaaaaaaaaaaaaaaaaaaaaaaaaaaaaaaaaaaaaaaaaaaaaaaaaaaaaaaaaaaaaaaaaaaaaaaaaaaaaaaaaaaaaaaaaaaaaaaaaaaaaaaaaaaaaaaaaaaaaaaaaaaaaaaaaaaaaaaaaaaaaaaaaaaaaa
aaaaaaaaaaaaaaaaaaaaaaaaaaacaaaaaaaaaaaaaaaaaaaaaaaaaaaaaaaaaaaaaaaaaaaaaaadadadadadaaaaaaaaaaaaaaaaaaaaaaaaaaaaaaaaaaaaaaaaaaaaaaaaaaaaaaaaaaaaaaaaaaaaaaaaaaaa
aaaaaaaaaaaaaaaaaaaaaaaaaaaaaaaaaaaaaaaaaaaaaaaaaaaaaaaaaaaaaaaaaaaaaaaaaaadadadadadaaaaaaaaaaaaaaaaaaaaaaaaaaaaaaaaaaaaaaaaaaaaaaaaaaaaaaaaaaaaaaaaaaaaaaaaaaaa
aaaaaaaaaaaaaaaaaaaaaaaaaaaaaaaaaaaaaaaaaaaaaaaaaaaaaaaaaaaaaaaaaaaaaaaaaaadadadadadaaaaaaaaaaaaaaaaaaaaaaaaaaaaaaaaaaaaaaaaaaaaaaaaaaaaaaaaaaaaaaaaaaaaaaaaaaaa
aaaaaaaaaaaaaaaaaaaaaaaaaaaaaaaaaaaaaaaaaaaaaaaaaaaaaaaaaaaaaaaaaaaaaaaaaaadadadadadaaaaaaaaaaaaaaaaaaaaaaaaaaaaaaabaaaaaaaaaaaaaaaaaaaaaaaaaaaaaaaaaaaaaaaaaaaa
aaaaaaaaaaaaaaaaaaaaaaaaaaaaaaaaaaaaaaaaaaaaaaaaadaaaaaaaaaeafaaacaaaaaaaaaaaaaaaaaaaaaaaaaaaaaaaaaaaaaaaaaaaaaaaaaaaaaaaaaaaaaaaaaaaaaaaaaaaaaaaaaaaaaaaaaaaaaa
aaaaaaaaaaaaagahahahahahahahahahaiaaaaaaaaaaaaaaaaaaaaaaaaajakaaaaaaaaaaaaaaaaaaaaaaaaaaaaaaaaaaaaaaaaaaaaaaaaaaaaaaaaaaaaaaaaaaaaaaaaaaaaaaaaaaaaaaaaaaaaaaaaaa
aaaaaaaaaaaaalamamamamamamamamamanaaaaaaaaaaaaaaaaaaaaaaaaaaaaaaaaaaaaaaaaaaaaaaaaaaaaaaaaaaaaaaaaaaaaaaaaaaaaaaaaaaaaaaaaaaaaaaaaaaaaaaaaaaaaaaaaaaaaaaaaaaaaaa
aaaaaaaaaaaaalamamamamamamamamamanaaaaaaaaaaaaaaaaaaaaaaaaaaaaaaaaaaaaaaaaaaaaaaaaaaaaaaaaaaaaaaaaaaaaaaaaaaaaaaaaaaaaaaaaaaaaaaaaaaaaaaaaaaaaaaaaaaaaaaaaaaaaaa
aaaaaoapaaaaaqararasamamamamamamanaaaaaaaaaaaaaaaaaaaaaaaaaaaaaaaaaaaaaaaaaaaaaaaaaaaaaaaaaaaaaaaaaaaaaaaaaaaaaaaaaaaaaaaaaaaaaaaaaaaaaaaaaaaaaaaaaaaaaaaaaaaaaa
aaaaatauaaaaaaaaaaalamamamamamamanaaaaaaaaaaaaaaaaaaaaaaaaaaaaaaaaaaaaaaaaaaaaaaaaaaaaaaaaaaaaaaaaaaaaaaaaaaaaaaaaaaaaaaaaaaaaaaaaaaaaavawaaaaaaaaaaaaaaaaaaaaaa
aaaaaaaaaaaaaaaaaaalamamamamamamanaaaaaaaaaaaaaaaaaaaaaaaaaaaaaaaaaaaaaaaaaaaaaaaaaaaaaaaaaaaaaaaaabaaaaaaaaaaaaaaaaaaaaaaaaaaaaaaaaaaaxayaaaaaaaaaaaaaaaaaaaaaa
aaaaaaaaaaaaaaaaaaalamamamamamamanaaaaaoapaaaaaaaaaaaaaaaaaaaaaaaaaaaaaaaaaaaaaaaaaaaaaaaaaaaaaaaaaaaaaaaaaaaaaaaaaaaaaaaaaaaaaaaaaaaaaaaaaaaaaaaaaaaaaaaaaaaaaa
aaaaaaaaaaaaaaaaaaaqararararararazaaaaatauaaaaaaaaaaaaaaaaaaaaaaaaaaaaaaaaaaaaaaaaaaadaaaaaaaaaaaaaaaaaaaaaaaaaaaaaaaaaaaaaaaaaaaaaaaaaaaaaaaaaaaaaaaaaaaaaaaaaa
aaaaaoapaaaoapaaaaaaaaaaaaaaaaaaaaaaaaaaaaaaaaaaaaaaaaaaaaaaaaaaaaaaaaaaaaaaaaaaaaaaaaaaaaaaaaaaaaaaaaaaaaaaaaaaaaaaaaaaaaaaaaaaaaaaaaaaaaaaaaaaaaaaaaaaaaaaaaaa
aaaaatauaaatauaaaaaaaaaaaaaaaaaaaoapaaaaaaaaaAaBaaaaaaaaaaaaaaaaaaaaaaaaaaaaaaaaaaaaaaaaaaaaaaaaaaaaaaaaaaaaaaaaaaaaaaaaaaaaaaaaaaaaaaaaaaaaaaaaaaaaaaaaaaaaaaaa
aaaaaaaaaoapaaaaaaaaaaaaaaaaaaaaatauaaaoapaaaCaDaaaaaaaaaaadaaaaaaaaaaaaaaaaaaaaaaaaaaaaaaaaaaaaaaaaaaaaaaaaaaaaaaaaaaaaaaaaaaaaaaaaaaaaaaaaaaaaaaaaaaaaaaaaaaaa
aoapaaaaatauaaaaaaaaaEaaaaaaaaaaaaaoapataFapaaaaaaaaaaaaaaaaaaaaaaaaaaaaaaaaaaaaaaaaaaaaaaaaaaaaaaaaaaaaaaaaaaaaaaaaaaaaaaaaaaaaaaaaaaaaaaaaaaaaaaaaaaaaaaaaaaaa
atauaaaaaaaaaaaaaaaaaGaaaaaaaaaaaaatauaaatauaaaoapaaaoapaaaaaaaaaaaaaaaaaaaaaaaaaaaaaaaaaaaaaaaaaaaaadaaaaaaaaaaaaaaaaaaaaaaaaaaaaaaaaaaaaaaaaaaaaaaaaaaaaaaaaaa
aHaoapaaaaaaaaaaaaaIaJaaaaaaaaaaaaaaaoapaaaaaaatauaaatauaaaaaaaaaaaaaaaaaaaaadaaaaaaaaaaaaaaaaaaaaaaaaaaaaaaaaaaaaaaaaaaaaaaaaaaaaaaaaaaaaaaaaaaaaaaaaaaaaaaaaaa
aKatauaaaaaaaaaaaaaGaaaaaaaaaaaoapaaataFapaoapaoapaaaaaaaoapaaaaaaaaaaaaaaaaaaaaaaaaaaaaaaaaaaaaaaaaaaaaaaaaaaaaaaaaaaaaaaaaaaaaaaaaaaaaaaaaaaaaaaaaaaaaaaaaaaaa
aKaKaLaaaaaaaaaaaIaJaaaaaaaaaaatauaaaaatauatauatauaoapaaatauaaaaaaaaaaaaaaaaaaaaaaaaaaaaaaaaaaaaaaaaaaaaaaaaaaaaaaaaaaaaaaaaaaaaaaaaaaaaaaaaaaaaaaaaaaaaaaaaaaaa
aKaoapaaaaaaaaagaMacaaaaaaaaaaaoapaaaoapaKaNaoapaoaOaFapaoapaoapaoapaoapaoapaoapaoapaaaaaaaaaaaaaaaaaaaaaaaaaaaaaaaaaaaaaaaaaaaaaaaaaaaaaaaaaaaaaaaaaaaaaaaaaaaa
aKatauaaaaaaaaalanaaaaaaaoapaPatauaoaOauaKaaataFaOaFaOaFaOaFaOaFaOaFaOaFaOaFaOaFaOauaaaaaQaRaaaSaaaaaaaaaaaaaaaaaaaaaaaaaaaaaaaaaaaaaaaaaaaaaaaaaaaaaaaaaaaaaaaa
aKaKaKaaaaaaagaTanaaaaaaatauaUaoapatauaaaKaKaoaOaFaOaFaOaFaOaFaOaFaOaFaOaFaOaFaOaFapaaaaaVaWaaaaaaaaaaaaaaaaaaaaaaaaaaaaaaaaaaaaaaaaadaaaaaaaaaaaaaaaaaaaaaaaaaa
aKaKaKaaaaagaTaXazaaaaaaaaaaaKatauaPaoapaaaKataFaOaFaOaFaOaFaOaFaOaFaOaFaOaFaOaFaOauaaaaaaaaaaaaaaaaaaaaaaaaaaaaaaaaaaaaaaaaaaaaaaaaaaaaaaaaaaaaaaaaaaaaaaaaaaaa
aKaKaKaaagaTaXazaaaaaaaaaaaUaKaaaaadatauaaaKaoaOaFaOaFaOaFaOaFaOaFaOaFaOaFaOaFaOaFapaaaaaaaaaaaaaaaaaaaaaaaaaaaaaaaaaaaaaaaaaaaaaaaaaaaaaaaaaaaaaaaaaaaaaaaaaaaa
aKaKaLaaalaXazaaaaaaaaaaaoapaLaoapaaaKaKaaaaatauataFaOaFaOaFaOaFaOaFaOaFaOaFaOaFaOauaaaaaaaaaaaaaaaaaaaaaaaaaaaaaaaaaaaaaaaaaaaaaaaaaaaaaaaaaaaaaaaaaaaaaaaaaaaa
aKaKaaaaaqaYaaaaaaaaaPaNatauaoaOauaUaKaaadaaaaadaoaOaFaOaFaOaFaOaFaOaFaOaFaOaFaOaFapaaaaaaaaaaaaaaaaaaaaaaaaaaaaaaaaaaaaaaaaaaaaaaaaaaaaaaaaaaaaaaaaaaaaaaaaaaaa
aKaLaaaaaaaGaaaaaaaaaaaaaaaaatauaUaPaaadaaaaaaaPatauatauataFaOaFaOaFaOaFaOaFaOaFaOauaaaaaaaaaaaaaaaaaaaaaaaaaaaaaaaaaaaaaaaaaaaaaaaaaaaaaaaaaaaaaaaaaaaaaaaaaaaa
aoapaaaaaaaZaaaaaaaNaabaaoapbbaoapaaaaaaaaaKaKaaadaaaaaaaoaOaFaOaFaOaFaOaFaOaFaOaFapaaaaaaaaaaaaaaaaaaaaaaaaaaaaaaaaaaaaaaaaaaaaaaaaaaaaaaaaaaaaaaaaaaaaaaaaaaaa
atauaaaaaaaaaaaaaaaaaaaaatauaoaOauaaaKaaaaaaaKaKaabcaabcatauataFaOaFaOaFaOaFaOaFaOauaaaaaaaaaaaaaaaaaaaaaaaaaaaaaaaaaaaaaaaaaaaaaaaaaaaaaaaaaaaaaaaaaaaaaaaaaaaa
baaPaPaaaaaaaaaaaaaaaPaaaKaoaOaubdaaaKaaaaaaaaaaaaacaaacaaaaaoaOaFaOaFaOaFaOaFaOaFapaaaaaaaaaaaaaaaaaaaaaaaaaaaaaaaaaaaaaaaaaaaaaaaaaaaaaaaaaaaaaaaaaaaaaaaaaaaa
apaPbeaaaaaaaaaaaaaaaaaaaKatauaKbbbbaPaaaKaaadaabcaaadaabcaaataFaOaFaOaFaOaFaOaFaOauaaaaaaaaaaaaaaaaaaaaaaaaaaaaaaaaaaaaaaaaaaaaaaaaaaaaaaaaaaaaaaaaaaaaaaaaaaaa
aFapaaaaaaaaaaaabeaaaaaaaKaoapaKaKaoapaaaKaaaaaaaaaaaaaaaaaaaUataFaOaFaOaFaOaFaOaFapaaaaaaaaaaaaaaaaaaaaaaaaaaaaaaaaaaaaaaaaaaaaaaaaaaaaaaaaaaaaaaaaaaaaaaaaaaaa
aOauaaaaaaaEaaaaaaaaaPaKaoaOaFapaoaOaFapaKaaaaaaaabcaabcaaaabfaoaOaFaOaFaOaFaOaFaOauaaaaaaaaaaaaaaaaaaaaaaaaaaaaaaaaaaaaaaaaaaaaaaaaaaaaaaaaaaaaaaaaaaaaaaaaaaaa
aubaaaaabgbhaiaaaaaaaKaKatauataFaOaFaOauaaaabdaaaoapaaaaaabdaoaOaFaOaFaOaFaOaFaOaFapaaaaaaaaaaaaaaaaaaaaaaaaaaaaaaaaaaaaaaaaaaaaaaaaaaaaaaaaaaaaaaaaaaaaaaaaaaaa
aoapbiaaaaaqazaaaaaaaKbaaoapaoaOaFaOauaUaKaKaHbaatauaaaaaoapataFaOaFaOaFaOaFaOaFaOauaaaaaaaaaaaaaaaaaaaaaaaaaaaaaaaaaaaaaaaaaaaaaaaaaaaaaaaaaaaaaaaaaaaaaaaaaaaa
atauaaaaaaaaaaaaaaaaaKaoaOaFaOaFaOaFapbfbjaoapaKaKaKbaaoaOauaoaOaFaOaFaOaFaOaFaOaFapaaaaaaaaaaaaaaaaaaaaaaaaaaaaaaaaaaaaaaaaaaaaaaaaaaaaaaaaaaaaaaaaaaaaaaaaaaaa
aaaoapaaaaagahaibkaaaKatauatauatauataubjadatauaKaKaKaKatauadataFaOaFaOaFaOaFaOaFaOauaaaaaaaaaaaaaaaaaaaaaaaaaaaaaaaaaaaaaaaaaaaaaaaaaaaaaaaaaaaaaaaaaaaaaaaaaaaa
"}
